Abelabetimaka	Abelabeti-maka
Abelabetimaka	Abela-beti-maka
Abelakeramima	Abela-keramima
Abelamaima	Abela-maima
Abelamehola	Abela-mehola
Abelasitima	Abela-sitima
AbelEgyptiana	Abel-Egyptiana
Abialbona	Abi-albona
abidimpianaran	abidim-pianaran
abidimpianarana	abidim-pianarana
Adamihanekeba	Adami-hanekeba
adilahy	adi-lahy
Adonibezeka	Adoni-bezeka
Adonizedeka	Adoni-zedeka
afabaraka	afa-baraka
Afabaraka	Afa-baraka
afaboninahitra	afa-boninahitra
afajaza	afa-jaza
afaka	afa-ka
afakeloka	afa-keloka
afaketaheta	afa-ketaheta
afamaina	afa-maina
afamamindra	afa-mamindra
afamandeha	afa-mandeha
afamandositra	afa-mandositra
afamandroso	afa-mandroso
afamiakatra	afa-miakatra
afamiala	afa-miala
afamidìna	afa-midìna
afamita	afa-mita
afamitsangana	afa-mitsangana
afamiverina	afa-miverina
afamivoaka	afa-mivoaka
afanandeha	afa-nandeha
afanandositra	afa-nandositra
afanivoaka	afa-nivoaka
afapahoriana	afa-pahoriana
afapahotana	afa-pahotana
afapo	afa-po
afapotsiny	afa-potsiny
afatsaona	afa-tsaona
afatsasatra	afa-tsasatra
afatsiny	afa-tsiny
afatsy	afa-tsy
Afatsy	Afa-tsy
afontsilo	afon-tsilo
ahazoampahalalana	ahazoam-pahalalana
ahazoampitia	ahazoam-pitia
ahidratsy	ahi-dratsy
ahimaitso	ahi-maitso
ahimatiso	ahi-matiso
ahitampahendrena	ahitam-pahendrena
ahitandoza	ahitan-doza
ahitandralehilahy	ahitan-dralehilahy
ahoantsy	ahoan-tsy
aizimpito	aizim-pito
aizimpitonao	aizim-pitonao
akanimborona	akanim-borona
akanjomboninahiny	akanjom-boninahiny
akanjompanjakana	akanjom-panjakana
akanjompisorona	akanjo-mpisorona
akanjonifiko	akanjo-nifiko
akorambolafotsinao	akoram-bolafotsinao
akorambolafotsy	akoram-bolafotsy
akorambolamena	akoram-bolamena
akorambolamenanao	akoram-bolamenanao
alahelompo	alahelom-po
alahelondrainao	alahelon-drainao
alaimpanahy	alaim-panahy
alaintahaka	alain-tahaka
alatrano	ala-trano
alatranonay	ala-tranonay
alatranony	ala-tranony
alatsadrà	alatsa-drà
alimpandry	alim-pandry
alimpito	alim-pito
alinaavy	alina-avy
alindahy	alin-dahy
Almondiblataima	Almon-diblataima
alobatolampy	alo-batolampy
alombolamena	alom-bolamena
Alonabakota	Alona-bakota
alondrano	alon-drano
alondranomasina	alon-dranomasina
alondranonao	alon-dranonao
amambolana	amam-bolana
amamboninahitra	amam-boninahitra
amamboninahitry	amam-boninahitry
amampitarainan	amam-pitarainan
amampondro	amam-pondro
amandanitra	aman-danitra
amandavenona	aman-davenona
amandaza	aman-daza
amandrà	aman-drà
amandreniko	aman-dreniko
amandrenin	aman-drenin
amandreninareo	aman-dreninareo
amandrenindrazazavavy	aman-drenin-drazazavavy
amandreniny	aman-dreniny
amandreny	aman-dreny
amangadra	aman-gadra
amanjanak	aman-janak
amanjanakao	aman-janakao
amanjanakareo	aman-janakareo
amanjanakay	aman-janakay
amanjanako	aman-janako
amanjanany	aman-janany
amanjavona	aman-javona
amankarena	aman-karena
amankazo	aman-kazo
amankeloka	aman-keloka
amankenatra	aman-kenatra
amankery	aman-kery
amankintana	aman-kintana
amantanako	aman-tanako
amantànan	aman-tànan
amantanana	aman-tanana
amantanany	aman-tanany
amantànany	aman-tànany
amantelo	aman-telo
amantoky	aman-toky
amantsain	aman-tsain
amantsainao	aman-tsainao
amantsakaiza	aman-tsakaiza
amantsara	aman-tsara
ambaindaiko	ambain-daiko
ambaindain	ambain-dain
ambaindainao	ambain-dainao
ambaindainy	ambain-dainy
ambalahanao	am-balahanao
ambalahanay	am-balahanay
ambalahany	am-balahany
ambalan	am-balan
ambarapahafantany	ambara-pahafantany
ambarapahafantatrao	ambara-pahafantatrao
ambarapahafantatro	ambara-pahafantatro
ambarapahafatin	ambara-pahafatin
ambarapahafatinareo	ambara-pahafatinareo
ambarapahafatiny	ambara-pahafatiny
ambarapahalanin	ambara-pahalanin
ambarapahalany	ambara-pahalany
ambarapahamarain	ambara-pahamarain
ambarapahanisy	ambara-pahanisy
ambarapaharavany	ambara-paharavany
ambarapaharingany	ambara-paharingany
ambarapaharivan	ambara-paharivan
ambarapahatanterahany	ambara-pahatanterahany
ambarapahatanterak	ambara-pahatanterak
ambarapahatapiny	ambara-pahatapiny
ambarapahatapitrao	ambara-pahatapitrao
ambarapahatapitry	ambara-pahatapitry
ambarapahatongan	ambara-pahatongan
ambarapahatongany	ambara-pahatongany
ambarapahatsy	ambara-paha-tsy
Ambarapahatsy	Ambara-paha-tsy
ambarapahavitanao	ambara-pahavitanao
ambarapahavitany	ambara-pahavitany
ambarapahazavan	ambara-pahazavan
ambarapahazavaratsin	ambara-pahazavaratsin
ambarapahitany	ambara-pahitany
Ambarapahoviana	Ambara-pahoviana
ambarapamangiko	ambara-pamangiko
Ambarapamoakany	Ambara-pamoakany
ambarapamono	ambara-pamono
ambarapamononay	ambara-pamononay
ambarapamonony	ambara-pamonony
Ambarapanaoko	Ambara-panaoko
ambarapanaon	ambara-panaon
ambarapanatanterany	ambara-panatanterany
Ambarapandahany	Ambara-pandahany
ambarapandaniko	ambara-pandaniko
ambarapandoanao	ambara-pandoanao
ambarapandringako	ambara-pandringako
ambarapandroakany	ambara-pandroakany
ambarapanefany	ambara-panefany
ambarapanirin	ambara-panirin
ambarapanongotra	ambara-panongotra
ambarapiaikiny	ambara-piaikiny
ambarapialako	ambara-pialako
ambarapiantsony	ambara-piantsony
Ambarapiboroaky	Ambara-piboroaky
ambarapiditrao	ambara-piditrao
ambarapihavin	ambara-pihavin
Ambarapihavin	Ambara-pihavin
ambarapihaviny	ambara-pihaviny
ambarapihinako	ambara-pihinako
ambarapilatsaky	ambara-pilatsaky
ambarapilazako	ambara-pilazako
ambarapitataovovonan	ambara-pitataovovonan
Ambarapitazan	Ambara-pitazan
ambarapitombony	ambara-pitombony
ambaravaran	am-baravaran
ambaravarana	am-baravarana
ambaravarankely	am-baravarankely
ambata	am-bata
ambatolampy	am-batolampy
ambavafo	am-bavafo
ambavahadiko	am-bavahadiko
ambavahadin	am-bavahadin
ambavahadinao	am-bavahadinao
ambavahadinareo	am-bavahadinareo
ambavahadinkazandrano	am-bavahadin-kazandrano
ambavahadintsika	am-bavahadintsika
ambavahadiny	am-bavahadiny
ambavahady	am-bavahady
ambavako	am-bavako
ambavan	am-bavan
ambavanao	am-bavanao
ambavany	am-bavany
ambavasa	am-bavasa
ambavasanao	am-bavasanao
ambavazohy	am-bava-zohy
ambavoroko	am-bavoroko
ambavoronareo	am-bavoronareo
ambavorony	am-bavorony
ambentinteny	ambentin-teny
ambilany	am-bilany
ambilia	am-bilia
amboadia	amboa-dia
amboahaolo	amboa-haolo
amboalohany	am-boalohany
amboampenao	amboam-penao
amboany	am-boany
amboarambary	amboaram-bary
ambodin	am-bodin
ambodirindrina	am-bodirindrina
ambodisambo	am-bodisambo
ambohitra	am-bohitra
ambohoka	am-bohoka
ambohokanao	am-bohokanao
ambozon	am-bozon
ambozonao	am-bozonao
ambyroapolo	amby-roa-polo
amimbehivavy	amim-behivavy
amimbola	amim-bola
amimboninahitra	amim-boninahitra
amimpahalalana	amim-pahalalana
amimpahamarinana	amim-pahamarinana
amimpahatalanjonana	amim-pahatalanjonana
amimpahatanjahana	amim-pahatanjahana
amimpahatezerana	amim-pahatezerana
amimpahendrena	amim-pahendrena
amimpahoriana	amim-pahoriana
amimpanajana	amim-panajana
amimpaty	amim-paty
amimpireharehana	amim-pireharehana
amindivay	amin-divay
amindokanga	amin-dokanga
amindoza	amin-doza
amindrainao	amin-drainao
amindrainy	amin-drainy
amindralehilahy	amin-dralehilahy
amindravehivavy	amin-dravehivavy
amindray	amin-dray
amindRegoela	amin-dRegoela
amindRehoboama	amin-dRehoboama
amindRehoma	amin-dRehoma
amindreninareo	amin-dreninareo
amindreniny	amin-dreniny
amindRezina	amin-dRezina
aminkarena	amin-karena
aminkenatra	amin-kenatra
aminkery	amin-kery
aminkorohoro	amin-korohoro
aminkovitra	amin-kovitra
aminny	amin-ny
amintahotra	amin-tahotra
amintory	amin-tory
amintsaina	amin-tsaina
amintsipìka	amin-tsipìka
amorondalana	amoron-dalana
amorondrano	amoron-drano
amorondranomasina	amoron-dranomasina
amorontsiraka	amoron-tsiraka
amorontsiraky	amoron-tsiraky
ampaharariany	am-paharariany
ampahatelontsekely	ampahatelon-tsekely
ampahibemaso	am-pahibemaso
ampahitra	am-pahitra
ampahitrao	am-pahitrao
ampaladianareo	am-paladianareo
ampaladiany	am-paladiany
ampamihinany	am-pamihinany
ampamoloako	am-pamoloako
ampamoloana	am-pamoloana
ampamoloanao	am-pamoloanao
ampamoloany	am-pamoloany
ampamonoana	am-pamonoana
ampamorianketra	am-pamorian-ketra
ampanahiny	am-panahiny
ampanahy	am-panahy
ampandehanana	am-pandehanana
ampandriako	am-pandriako
ampandriana	am-pandriana
ampandrianareo	am-pandrianareo
ampandriany	am-pandriany
ampanotrehana	am-panotrehana
ampantsakana	am-pantsakana
amparafara	am-parafara
amparafarany	am-parafarany
amparan	am-paran
amparany	am-parany
amparavodilanitra	am-paravodilanitra
amparavodilavaka	ampara-vodilavaka
amparavodilavaka	am-paravodi-lavaka
amparihin	am-parihin
ampasan	am-pasan
ampasana	am-pasana
ampasandrazanao	am-pasan-drazanao
ampasandrazany	am-pasan-drazany
ampasany	am-pasany
ampatana	am-patana
ampatorana	am-patorana
ampaty	am-paty
ampehezana	am-pehezana
ampelatanako	am-pelatanako
ampelatanan	am-pelatanan
ampelatànan	ampela-tànan
ampelatanany	am-pelatanany
ampelatànany	ampela-tànany
ampempamboalobok	ampempam-boalobok
ampempamboaloboka	ampempam-boaloboka
ampiakarana	am-piakarana
ampiangonana	am-piangonana
ampiantsetsetra	ampian-tsetsetra
ampidinan	am-pidinan
ampidinana	am-pidinana
ampidirana	am-pidirana
ampielezana	am-pielezana
ampierena	am-pierena
ampiereny	am-piereny
ampifaliana	am-pifaliana
ampihinanambilona	am-pihinanam-bilona
ampihinanana	am-pihinanana
ampikapohana	am-pikapohana
ampinonoana	am-pinonoana
ampiononindreniny	ampiononin-dreniny
ampipetrahana	am-pipetrahana
ampisotroandivay	am-pisotroan-divay
ampita	am-pita
ampitan	am-pitan
ampitenenana	am-pitenenana
ampiterahana	am-piterahana
ampitoerany	am-pitoerany
ampitomaniana	am-pitomaniana
ampitondrana	am-pitondrana
ampitsanganana	am-pitsanganana
ampitsarana	am-pitsarana
ampivavahana	am-pivavahana
ampo	am-po
ampofoako	am-pofoako
ampofoanareo	am-pofoanareo
ampofoandreniny	am-pofoan-dreniny
ampofoany	am-pofoany
ampoko	am-poko
ampon	am-pon
amponao	am-ponao
amponareo	am-ponareo
amponay	am-ponay
ampongabendanitra	ampongaben-danitra
ampongabendanitro	ampongaben-danitro
ampongatapaka	amponga-tapaka
amponosana	am-ponosana
ampontsika	am-pontsika
ampony	am-pony
ampototr	am-pototr
ampototry	am-pototry
ampovoanao	am-povoanao
anabavindrainao	anabavin-drainao
anabavindrainy	anabavin-drainy
anadahindRebeka	anadahin-dRebeka
anadahindreninao	anadahin-dreninao
anadahindreniny	anadahin-dreniny
anadrainao	ana-drainao
anangonambato	anangonam-bato
anaovandraharaha	anaovan-draharaha
anaovantsoa	anaovan-tsoa
anapanahy	ana-panahy
anarambaovao	anaram-baovao
anarandrainy	anaran-drainy
anarandralehilahy	anaran-dralehilahy
anarandreniny	anaran-dreniny
anarantenany	anaran-tenany
anarantsampy	anaran-tsampy
anariambato	anariam-bato
anatirova	anati-rova
anatrehandrainao	anatrehan-drainao
anatrehandralehilahy	anatrehan-dralehilahy
anatrehandRehoma	anatrehan-dRehoma
andafin	an-dafin
andafintsaha	an-dafin-tsaha
andafiny	an-dafiny
andafy	an-dafy
andaiko	an-daiko
andain	an-dain
andainao	an-dainao
andainareo	an-dainareo
andainRahely	an-dain-Rahely
andainy	an-dainy
andalambe	an-dalambe
andalambe	an-dalam-be
andalamben	an-dalamben
andalambenay	an-dalambenay
andalambeny	an-dalambeny
andalana	an-dalana
andalàna	an-dalàna
andamosin	an-damosin
andamosiny	an-damosiny
andanin	an-danin
andaniny	an-daniny
andanitra	an-danitra
andanjany	an-danjany
andaona	an-daona
andapa	an-dapa
andapako	an-dapako
andapan	an-dapan
andapanao	an-dapanao
andapantsika	an-dapantsika
andapany	an-dapany
andatabatra	an-databatra
andavabato	an-dava-bato
andavaka	an-davaka
andavaky	an-davaky
andavan	an-davan
andavany	an-davany
andavatany	an-dava-tany
andavenona	an-davenona
anday	an-day
andevovavy	andevo-vavy
andiany	an-diany
andoha	an-doha
andohako	an-dohako
andohaliny	an-dohaliny
andohan	an-dohan
andohanao	an-dohanao
andohanareo	an-dohanareo
andohanay	an-dohanay
andohany	an-dohany
andoharano	an-doharano
andohasaha	an-dohasaha
andohasahan	an-dohasahan
andohasahandriaka	an-dohasahan-driaka
andohasambo	an-doha-sambo
andolompo	an-dolom-po
andovia	an-dovia
andovian	an-dovian
andoviany	an-doviany
andr	an-dr
andRabsake	an-dRabsake
andRahaba	an-dRahaba
andRahely	an-dRahely
andrainy	an-drainy
andralehilahy	an-dralehilahy
andRama	an-dRama
andranomasina	an-dranomasina
andravahany	an-dravahany
andravehivavy	an-dravehivavy
andrazazavavy	an-drazazavavy
andRebeka	an-dRebeka
andRehoboama	an-dRehoboama
andreninareo	an-dreninareo
andreniny	an-dreniny
andReo	an-dReo
andriafo	andri-afo
andriamanibaovao	andriamani-baovao
andriamanibavin	andriamani-bavin
andriamanibavy	andriamani-bavy
andriamanibolafotsiny	andriamani-bolafotsiny
andriamanibolamena	andriamani-bolamena
andriamanibolamenany	andriamani-bolamenany
andriamanidehibe	andriamani-dehibe
andriamanikafa	andriamani-kafa
andriamaninitsiizy	andriamanini-tsi-izy
andriamanitsiizy	andriamani-tsi-izy
andriandahin	andrian-dahin
andriandahy	andrian-dahy
andriandehibe	andrian-dehibe
andriandehilahy	andrian-dehilahy
andriankazo	andrian-kazo
Andriantokana	Andrian-tokana
andringiringy	an-dringiringy
andrintsambo	andrin-tsambo
andrintsambonao	andrin-tsambonao
andrirahona	andri-rahona
Andrirahona	Andri-rahona
anefitr	an-efitr
anefitra	an-efitra
anefitrano	an-efi-trano
anefitranony	an-efi-tranony
anefitry	an-efitry
anfitra	an-fitra
angalandrà	angalan-drà
anidina	an-idina
anila	an-ila
anilandoharano	anilan-doharano
anisany	an-isany
anjabolafotsy	anja-bolafotsy
anjabolamena	anja-bolamena
anjaby	anja-by
anjaraandron	anjara-andron
anjaraasany	anjara-asany
anjarabirikinareo	anjara-birikinareo
anjaraentany	anjara-entany
Anjarafahoriako	Anjara-fahoriako
anjarafananana	anjara-fananana
anjarafanapahany	anjara-fanapahany
anjarafanompoana	anjara-fanompoana
anjarafiandrasana	anjara-fiandrasana
anjarafiveloman	anjara-fiveloman
anjarahanin	anjara-hanin
anjarahanina	anjara-hanina
anjarahaninao	anjara-haninao
anjarahaniny	anjara-haniny
anjaralovany	anjara-lovany
anjarampolo	anjaram-polo
anjarandrery	anjaran-drery
anjarandroa	anjaran-droa
anjararaharaha	anjara-raharaha
anjararaharahan	anjara-raharahan
anjararaharahanao	anjara-raharahanao
anjararaharahanareo	anjara-raharahanareo
anjararaharahany	anjara-raharahany
anjohy	an-johy
anjoromparafara	an-jorom-parafara
anjoron	an-joron
anjorondalambe	an-joron-dalambe
anjorondalana	an-joron-dalana
anjorontrano	an-joron-trano
anjorony	an-jorony
ankabiazambahoaka	ankabiazam-bahoaka
ankadilanana	an-kadilanana
ankady	an-kady
ankalalahana	an-kalalahana
ankalesy	an-kalesy
ankamarenana	an-kamarenana
ankamehana	an-kamehana
ankandemponana	an-kandemponana
ankarihary	an-karihary
ankarona	an-karona
ankasarotana	an-kasarotana
ankatakonana	an-katakonana
ankaterena	an-katerena
ankatezerana	an-katezerana
ankatoko	an-katoko
ankatoky	an-katoky
ankavanako	an-kavanako
ankavanan	an-kavanan
ankavanana	an-kavanana
ankavananao	an-kavananao
ankavanany	an-kavanany
ankavia	an-kavia
ankavianao	an-kavianao
ankaviany	an-kaviany
ankavoana	an-kavoana
ankazakazaka	an-kazakazaka
ankazo	an-kazo
ankeriny	an-keriny
Ankeriny	An-keriny
anketena	an-ketena
ankeviny	an-keviny
ankevitry	an-kevitry
ankianja	an-kianja
ankianjan	an-kianjan
ankianjanao	an-kianjanao
ankianjany	an-kianjany
ankibo	an-kibo
ankiboko	an-kiboko
ankibon	an-kibon
ankibonao	an-kibonao
ankibondrainy	an-kibon-drainy
ankibondreniko	an-kibon-dreniko
ankibondreniny	an-kibon-dreniny
ankibony	an-kibony
ankihibentànany	ankihiben-tànany
ankihibentongony	ankihiben-tongony
ankilan	an-kilan
ankilany	an-kilany
ankira	an-kira
ankitapo	an-kitapo
ankitaponao	an-kitaponao
ankizivavindRahely	ankizivavin-dRahely
ankizivavinRahely	ankizivavin-Rahely
ankoatry	an-koatry
ankohonandrainao	ankohonan-drainao
ankohonandrainy	ankohonan-drainy
antafika	an-tafika
antahony	an-tahony
antakolany	an-takolany
antambohonao	an-tambohonao
antampon	an-tampon
antampondohan	an-tampon-dohan
antampondohany	an-tampon-dohany
antampontendrombohitra	an-tampon-tendrombohitra
antampontrano	an-tampontrano
antampontrano	an-tampon-trano
antampontranony	an-tampon-tranony
antampony	an-tampony
antanako	an-tanako
antanambehivavy	an-tanam-behivavy
antanan	an-tanan
antànan	an-tànan
antanana	an-tanana
antanàna	an-tanàna
antanànan	an-tanànan
anTanànan	an-Tanànan
antanànanao	an-tanànanao
antanànanareo	an-tanànanareo
antanànany	an-tanànany
antananao	an-tananao
antanànaolo	an-tanànaolo
antananareo	an-tananareo
antananay	an-tananay
antanandralehilahy	an-tanan-dralehilahy
antànandravehivavy	an-tànan-dravehivavy
antanantsika	an-tanantsika
antanany	an-tanany
antànany	an-tànany
antanety	an-tanety
antanihay	an-tani-hay
antanimbarin	an-tanimbarin
antanimbarinao	an-tanimbarinao
antanimbariny	an-tanimbariny
antanimbary	an-tanimbary
antanimboaloboka	an-tanim-boaloboka
antanimboalobony	an-tanim-boalobony
antanimbolin	an-tanimbolin
antanimboliny	an-tanimboliny
antanimboly	an-tanimboly
antanin	an-tanin
antaniny	an-taniny
antany	an-tany
antaratasy	an-taratasy
antavoahanginao	an-tavoahanginao
antempolin	an-tempolin
antempoliny	an-tempoliny
antenatenan	an-tenatenan
antenatenany	an-tenatenany
Antenda	An-tenda
antendan	an-tendan
antendrombohiny	an-tendrombohiny
antendrombohitr	an-tendrombohitr
antendrombohitra	an-tendrombohitra
antendrombohitrao	an-tendrombohitrao
antendrombohitrareo	an-tendrombohitrareo
antendrombohitro	an-tendrombohitro
antendrombohitry	an-tendrombohitry
antendron	an-tendron
antendrony	an-tendrony
anteninaina	an-teninaina
antery	an-tery
antilikambo	an-tilikambo
antilikambony	an-tilikambony
antipanahy	anti-panahy
antobin	an-tobin
antobiny	an-tobiny
antoby	an-toby
antokoana	an-tokoana
antokonana	an-tokonana
antokony	an-tokony
antokotaniny	an-tokotaniny
antokotokony	an-tokotokony
antomponenana	antom-ponenana
antondraka	an-tondraka
antongony	an-tongony
antongotra	an-tongotra
antongotrareo	an-tongotrareo
antonjavatra	anton-javatra
antontambary	antontam-bary
antontambato	antontam-bato
antontanbary	antontan-bary
antontanjavatra	antontan-javatra
antontankazo	antontan-kazo
antrano	an-trano
anTranoala	an-Tranoala
antranobe	an-tranobe
antranoben	an-tranoben
antranobeny	an-tranobeny
antranoko	an-tranoko
antranomaizina	an-tranomaizina
antranomaizina	an-trano-maizina
antranombahiny	an-tranom-bahiny
antranombehivavy	an-tranom-behivavy
antranon	an-tranon
antranonao	an-tranonao
antranonareo	an-tranonareo
antranonay	an-tranonay
antranondivay	an-tranon-divay
antranondrainao	an-tranon-drainao
antranondrainy	an-tranon-drainy
antranondralehilahy	an-tranon-dralehilahy
antranondRimona	an-tranon-dRimona
antranontranony	an-tranontranony
antranontsika	an-tranontsika
antranony	an-tranony
antratrako	an-tratrako
antratran	an-tratran
antratranao	an-tratranao
antratranareo	an-tratranareo
antratrandreniny	an-tratran-dreniny
antratrany	an-tratrany
Antsabatra	An-tsabatra
antsaha	an-tsaha
antsahako	an-tsahako
antsahan	an-tsahan
antsahanay	an-tsahanay
antsahany	an-tsahany
antsaiko	an-tsaiko
antsaina	an-tsaina
antsainao	an-tsainao
antsainareo	an-tsainareo
antsainy	an-tsainy
antsambo	an-tsambo
antsambokely	an-tsambokely
antsampanandalana	an-tsampanan-dalana
antsandrinao	an-tsandrinao
antsasaky	an-tsasaky
antsasany	an-tsasany
antsefaky	an-tsefaky
antsefatsefak	an-tsefatsefak
antsefatsefaky	an-tsefatsefaky
antsena	an-tsena
antsininy	an-tsininy
antsisin	an-tsisin
antsisindambanao	an-tsisin-dambanao
antsisindambany	an-tsisin-dambany
antsisiny	an-tsisiny
antsitrapo	an-tsitrapo
antsoavaly	an-tsoavaly
antsobiky	an-tsobiky
antsofiko	an-tsofiko
antsofinao	an-tsofinao
antsofiny	an-tsofiny
antsompitra	an-tsompitra
antsompitro	an-tsompitro
antsoratra	an-tsoratra
antsoroka	an-tsoroka
antsorokao	an-tsorokao
antsoroko	an-tsoroko
antsorony	an-tsorony
apongabendanitra	apongaben-danitra
arahindranonorana	arahin-dranonorana
arakeviny	ara-keviny
arakevitry	ara-kevitry
Aramazoba	Arama-zoba
Aramoaba	Ara-moaba
Arbotamoaba	Arbota-moaba
aredmandringana	ared-mandringana
aretimahasahozanina	areti-mahasahozanina
aretimandoza	areti-mandoza
aretimandringana	areti-mandringana
aretimandripaka	areti-mandripaka
aretimbe	aretim-be
aretindratsin	aretin-dratsin
arofanina	aro-fanina
asandoza	asan-doza
asandravehivavy	asan-dravehivavy
asantanan	asan-tanan
asantànan	asan-tànan
asantananao	asan-tananao
asiandiloilo	asian-diloilo
asiandrano	asian-drano
asiandratsy	asian-dratsy
asiandromoromo	asian-dromoromo
asiantsira	asian-tsira
Astartakarnaima	Astarta-karnaima
ataondravehivavy	ataon-dravehivavy
Atarotadara	Atarot-adara
atilavaka	ati-lavaka
atinkena	atin-kena
atitrano	ati-trano
atitranony	ati-tranony
Atrotabetijoaba	Atrota-beti-joaba
Atrotasofana	Atrota-sofana
atsimoatsinana	atsimo-atsinana
atsimoatsinanana	atsimo-atsinanana
atsinanantanàna	atsinanan-tanàna
Aznotatabara	Aznota-tabara
azompahoriana	azom-pahoriana
Azompahoriana	Azom-pahoriana
azompanafody	azom-panafody
azompanahy	azom-panahy
Azompanahy	Azom-panahy
azondoza	azon-doza
azondrano	azon-drano
azonkenatra	azon-kenatra
Azonkolikoly	Azon-kolikoly
azonkorohoro	azon-korohoro
azontahotra	azon-tahotra
azontsampona	azon-tsampona
azontsindrimandry	azon-tsindrimandry
baingantany	baingan-tany
Balaberita	Bala-berita
Balagada	Bala-gada
Balahamona	Bala-hamona
Balahanana	Bala-hanana
Balahazora	Bala-hazora
Balahermona	Bala-hermona
Balajoda	Bala-joda
Balameona	Bala-meona
Balapeora	Bala-peora
Balaperazima	Bala-perazima
Balasalisa	Bala-salisa
Balatamara	Bala-tamara
Balazeboba	Bala-zeboba
Balazefona	Bala-zefona
Baletabera	Baleta-bera
Bamotabala	Bamota-bala
Barjona	Bar-jona
Beneberaka	Bene-beraka
Benejakana	Bene-jakana
Benhanana	Ben-hanana
Beniadada	Beni-adada
Benidakera	Beni-dakera
Benigabera	Beni-gabera
Benihadada	Beni-hadada
Benihaseda	Beni-haseda
Benihora	Beni-hora
Benzoheta	Ben-zoheta
Beralahairoy	Bera-lahai-roy
Berelima	Ber-elima
Berisheba	Beri-sheba
Betanata	Bet-anata
Betanota	Bet-anota
Betaraba	Bet-araba
Betarabà	Bet-arabà
Betarbela	Bet-arbela
Betazmaveta	Bet-azmaveta
Betedena	Bet-edena
Betemeka	Bet-emeka
Betibalameona	Beti-bala-meona
Betibara	Beti-bara
Betibiry	Beti-biry
Betidagona	Beti-dagona
Betidiblataima	Beti-diblataima
Betigadera	Beti-gadera
Betigamola	Beti-gamola
Betigilgala	Beti-gilgala
Betihaezela	Beti-haezela
Betihakerema	Beti-hakerema
Betiharama	Beti-harama
Betiharana	Beti-harana
Betihogla	Beti-hogla
Betihorona	Beti-horona
Betijesimota	Beti-jesimota
Betikara	Beti-kara
Betileafra	Beti-le-afra
Betilebaota	Beti-lebaota
Betimaka	Beti-maka
Betimarkabota	Beti-markabota
Betimeona	Beti-meona
Betinimra	Beti-nimra
Betipaleta	Beti-paleta
Betipazeza	Beti-pazeza
Betipeora	Beti-peora
Betirehoba	Beti-rehoba
Betisana	Beti-sana
Betisemesita	Beti-semesita
Betisemesy	Beti-semesy
Betisita	Beti-sita
Betitapoa	Beti-tapoa
Betizora	Beti-zora
Betlehemajoda	Betlehema-joda
bibidia	bibi-dia
Bongontavy	Bongon-tavy
borikidia	boriki-dia
borikivavidia	borikivavi-dia
diandrainy	dian-drainy
diankapoka	dian-kapoka
diantongotrao	dian-tongotrao
Dibongada	Dibon-gada
didimpananana	didim-pananana
didimpanjakana	didim-panjakana
didindrainao	didin-drainao
dimamjato	dimam-jato
dimampolo	dimam-polo
dimampoloandro	dimam-poloandro
dimanjato	diman-jato
dinanjato	dinan-jato
dintikazo	dinti-kazo
ditinkazo	ditin-kazo
Ebedameleka	Ebeda-meleka
Ebedameleta	Ebeda-meleta
efabolana	efa-bolana
Efabolana	Efa-bolana
efadahy	efa-dahy
efajato	efa-jato
efajoro	efa-joro
Efajoro	Efa-joro
efapolo	efa-polo
Efapolo	Efa-polo
efatoko	efa-toko
Efesadamima	Efesa-damima
efitrano	efi-trano
efitranon	efi-tranon
efitranonao	efi-tranonao
efitranony	efi-tranony
Eglataselisia	Eglata-selisia
Egletaselisia	Egleta-selisia
elaboromailala	ela-boromailala
elaborona	ela-borona
eladrivotra	ela-drivotra
Elbetela	El-betela
EleloheIsiraely	El-elohe-Isiraely
Elonbetihanana	Elon-beti-hanana
Elparana	El-parana
Enamispata	Ena-mispata
Endora	En-dora
Endrehindatsa	Endrehin-datsa
endrijavatra	endri-javatra
Eneglaima	En-eglaima
Enganima	En-ganima
Enhakore	En-hakore
Enhazora	En-hazora
enimbavy	enim-bavy
enimbolana	enim-bolana
enimpolo	enim-polo
enindahy	enin-dahy
enindrantsana	enin-drantsana
eninjato	enin-jato
Eninjato	Enin-jato
enintaona	enin-taona
Enintaona	Enin-taona
Enjedy	En-jedy
Enrimona	En-rimona
Enrogela	En-rogela
Ensemesy	En-semesy
entamavesatra	enta-mavesatra
entantsika	entan-tsika
Entapoa	En-tapoa
entimaharesy	enti-maharesy
entimahasitrana	enti-mahasitrana
entimahatanteraka	enti-mahatanteraka
entimamely	enti-mamely
entimamitaka	enti-mamitaka
entimanafaka	enti-manafaka
entimanakona	enti-manakona
entimanalady	enti-manalady
entimanamafy	enti-manamafy
entimanamarina	enti-manamarina
entimanamboatra	enti-manamboatra
entimanao	enti-manao
entimanavotra	enti-manavotra
entimandatsadrà	enti-mandatsa-drà
entimandositra	enti-mandositra
entimandrava	enti-mandrava
entimandringana	enti-mandringana
entimanenjika	enti-manenjika
entimanohitra	enti-manohitra
entimanompo	enti-manompo
entimiady	enti-miady
entimiala	enti-miala
entimihaino	enti-mihaino
entimila	enti-mila
entimody	enti-mody
entimpo	entim-po
entindralehilahy	entin-dralehilahy
entindrameva	entin-drameva
erampaladia	eram-paladia
erantànan	eran-tànan
erantanandroa	eran-tanan-droa
erantànandroa	eran-tànan-droa
erantànanila	eran-tànan-ila
Esarahadona	Esara-hadona
esonteny	eson-teny
esorintanana	esorin-tanana
Evilamerodaka	Evila-merodaka
Eziongebera	Ezion-gebera
fadimbolana	fadim-bolana
fadimbolany	fadim-bolany
fadintseranana	fadin-tseranana
fahabetsahankanina	fahabetsahan-kanina
fahadimampolo	fahadimam-polo
fahadimy	faha-dimy
fahadiovampo	fahadiovam-po
fahadisoankevitra	fahadisoan-kevitra
fahafahambaraka	fahafaham-baraka
fahafahamboninahitra	fahafaham-boninahitra
fahafahamboninahitray	fahafaham-boninahitray
fahafahamboninahitro	fahafaham-boninahitro
fahafolonkaren	fahafolon-karen
fahafolonkarena	fahafolon-karena
fahafolonkarenareo	fahafolon-karenareo
fahagagandehibe	fahagagan-dehibe
fahaizamilaza	fahaiza-milaza
fahaizampanahy	fahaizam-panahy
fahaizanjavatra	fahaizan-javatra
fahakiviampanahy	fahakiviam-panahy
fahalalampamonjena	fahalalam-pamonjena
fahalalinantsaina	fahalalinan-tsaina
fahalatsahandrà	fahalatsahan-drà
fahalemempanahimpahamamarinana	fahalemem-panahim-pahamamarinana
fahalemempanahin	fahalemem-panahin
fahalemempanahy	fahalemem-panahy
fahalemenpanahy	fahalemen-panahy
fahamafiampo	fahamafiam-po
fahamafiankatoka	fahamafian-katoka
fahamaimaizantsaina	fahamaimaizan-tsaina
fahambanitoetry	fahambani-toetry
fahamorampanahin	fahamoram-panahin
fahamorampanahinao	fahamoram-panahinao
fahamorampanahiny	fahamoram-panahiny
fahamorampanahy	fahamoram-panahy
fahandroankena	fahandroan-kena
fahankanina	fahan-kanina
faharavoampo	faharavoam-po
faharavoravoampo	faharavoravoam-po
faharipo	fahari-po
faharipon	fahari-pon
faharipony	fahari-pony
faharoapolo	faharoa-polo
fahasaropiaoronao	fahasaro-piaoronao
fahasaropiaro	fahasaro-piaro
fahasaropiaroko	fahasaro-piaroko
fahasaropiaron	fahasaro-piaron
fahasaropiaronao	fahasaro-piaronao
fahasaropiarony	fahasaro-piarony
fahasaropo	fahasaro-po
fahasaropony	fahasaro-pony
fahasoavampanahy	fahasoavam-panahy
fahatanjahantsaina	fahatanjahan-tsaina
fahatanjahantsainareo	fahatanjahan-tsainareo
fahatelopolo	fahatelo-polo
fahatezerandehilahy	fahatezeran-dehilahy
fahatezerandRezina	fahatezeran-dRezina
fahatokiampoana	fahatokiam-poana
fahatsarambika	fahatsaram-bika
fahatsarampanahy	fahatsaram-panahy
fahatsarampo	fahatsaram-po
fahatsarantarehy	fahatsaran-tarehy
fahatsindriampo	fahatsindriam-po
fahatsorampo	fahatsoram-po
fahavaloko	fa-havaloko
fahavalopolo	fahavalo-polo
fahavelondrainao	fahavelon-drainao
fahaverezankevitra	fahaverezan-kevitra
fahaverezantsaina	fahaverezan-tsaina
fahavetavetanao	fahavetave-tanao
fahavononampanahy	fahavononam-panahy
fahazavantsain	fahazavan-tsain
fahazavantsaina	fahazavan-tsaina
fahazoanjavatra	fahazoan-javatra
fahazoankarena	fahazoan-karena
fahefapolo	fahefa-polo
fahelavelona	fahela-velona
fahenimbolana	fahenim-bolana
faheninjato	fahenin-jato
fahiratantsaina	fahiratan-tsaina
fahitandoza	fahitan-doza
fahitantory	fahitan-tory
fahitsiampo	fahitsiam-po
fahononampo	fahononam-po
fahononamponareo	fahononam-ponareo
fahononantena	fahononan-tena
fahoriampanahy	fahoriam-panahy
faingambava	faingam-bava
faingampamoaka	faingam-pamoaka
faingampandeha	faingam-pandeha
faingantongotra	faingan-tongotra
faingantsoratra	faingan-tsoratra
faizandrainy	faizan-drainy
fakambadin	fakam-badin
fakampanahy	fakam-panahy
fakombary	fakom-bary
famahanantenona	famahanan-tenona
famaizandrainy	famaizan-drainy
famakianteny	famakian-teny
famaliandratsy	famalian-dratsy
famaliantsoa	famalian-tsoa
famantarandalana	famantaran-dalana
famatorampahafatesana	famatoram-pahafatesana
famatoran	famato-ran
fambolemboaloboka	fambolem-boaloboka
famelankeloka	famelan-keloka
fametrahantànan	fametrahan-tànan
fametrahantanana	fametrahan-tanana
famiazamboalobok	famiazam-boalobok
famiazamboaloboka	famiazam-boaloboka
famiazamboaloboky	famiazam-boaloboky
familiantsambo	familian-tsambo
famindrampeko	famindram-peko
famindrampo	famindram-po
Famindrampo	Famindram-po
famindrampoko	famindram-poko
famindrampon	famindram-pon
famindramponao	famindram-ponao
famindrampony	famindram-pony
famitahantena	famitahan-tena
famoahankevitry	famoahan-kevitry
famohamandrintsoavaly	famohamandrin-tsoavaly
famoizampo	famoizam-po
famonjendehibe	famonjen-dehibe
famoriambola	famoriam-bola
famoriandrano	famorian-drano
famoriandranon	famorian-dranon
famoriandranonao	famorian-dranonao
famoriandranony	famorian-dranony
fampahasaropiaro	fampahasaro-piaro
fampakarambadin	fampakaram-badin
fampakarambady	fampakaram-bady
fampiantranoambahiny	fampiantranoam-bahiny
fampisehoamboninahitra	fampisehoam-boninahitra
fanabolafotsiny	fana-bolafotsiny
fanahimpahalotoana	fanahim-pahalotoana
fanahimpahandevozana	fanahim-pahandevozana
fanahimpahendrena	fanahim-pahendrena
fanahimpijangajangana	fanahim-pijangajangana
fanalambaraka	fanalam-baraka
fanalamboadinareo	fanalam-boadinareo
fanalamboadiny	fanalam-boadiny
fanampenamaso	fanampena-maso
fananantsiny	fananan-tsiny
fananarampoana	fananaram-poana
fananarandrainy	fananaran-drainy
fanangonamboankazo	fanangonam-boankazo
fananoantena	fananoan-tena
fanantenanjavatra	fanantenan-javatra
fanaombavy	fanaom-bavy
fanaondrazana	fanaon-drazana
fanaondrazanareo	fanaon-drazanareo
fanaovamofo	fanaova-mofo
fanaovamofonao	fanaova-mofonao
fanaovampanatovana	fanaovam-panatovana
fanaovampanavotana	fanaovam-panavotana
fanaovampeo	fanaovam-peo
fanaovandraharaha	fanaovan-draharaha
fanaovandratsy	fanaovan-dratsy
fanaovanjavatra	fanaovan-javatra
fanaovanjiro	fanaovan-jiro
fanaovanjironao	fanaovan-jironao
fanaovanjirony	fanaovan-jirony
fanaovanpanavotana	fanaovan-panavotana
fanaovantsoa	fanaovan-tsoa
fanaranampo	fanaranam-po
fanasampifankatiavanareo	fanasam-pifankatiavanareo
fanasampifankatiavany	fanasam-pifankatiavany
fanaterampanatitra	fanateram-panatitra
fanatidrà	fanati-drà
fanatipahamarinana	fanati-pahamarinana
fanatipahatsiarovana	fanati-pahatsiarovana
fanatipanahy	fanati-panahy
fanatipanalamboadinareo	fanati-panalamboadinareo
fanatipanalamboady	fanati-panalamboady
fanatipanokanana	fanati-panokanana
fanatipanonerana	fanati-panonerana
fanatipanonerany	fanati-panonerany
fanatipiderana	fanati-piderana
fanatipihavanana	fanati-pihavanana
fanatipihavananao	fanati-pihavananao
fanatipihavananareo	fanati-pihavananareo
fanatipihavanany	fanati-pihavanany
fanatipihavavana	fanati-pihavavana
fanatipiravoravoana	fanati-piravoravoana
fanatipisaorana	fanati-pisaorana
fanatipoana	fanati-poana
fanatitsitrapo	fanati-tsitrapo
fanatitsitraponao	fanati-tsitraponao
fanatitsitraponareo	fanati-tsitraponareo
fanatitsitrapony	fanati-tsitrapony
fandaharanteniny	fandaharan-teniny
fandaniampoana	fandaniam-poana
fandatsahandrà	fandatsahan-drà
fandatsahandrakitra	fandatsahan-drakitra
fandàtsan	fandà-tsan
fandeferampahoriana	fandeferam-pahoriana
fandehanantsambo	fandehanan-tsambo
fandevenambahiny	fandevenam-bahiny
fandikandalàna	fandikan-dalàna
fandikanteny	fandikan-teny
fandoavambola	fandoavam-bola
fandoroambiriky	fandoroam-biriky
fandoroantsokay	fandoroan-tsokay
fandraisambola	fandraisam-bola
fandraofandavenona	fandraofan-davenona
fandrendrehamby	fandrendreham-by
fandresendahatra	fandresen-dahatra
fandriambahiny	fandriam-bahiny
fandriampitiavana	fandriam-pitiavana
fandritotofana	fandri-totofana
fanekempihavanana	fanekem-pihavanana
fanekempirahalahiana	fanekem-pirahalahiana
fanendasamofo	fanendasa-mofo
fanendasamofonao	fanendasa-mofonao
fanenjehanaary	fanenjehana-ary
fanetezamboaloboka	fanetezam-boaloboka
fanetrentena	fanetren-tena
fanevatevambahoaka	fanevatevam-bahoaka
fangalandrano	fangalan-drano
fangalankazo	fangalan-kazo
fangaoby	fangao-by
fangidiampanahy	fangidiam-panahy
fanidinampanatitra	fanidinam-panatitra
fanindronanomby	fanindronan-omby
faniriandratsy	fanirian-dratsy
faniriankanina	fanirian-kanina
fanjakampisorona	fanjaka-mpisorona
fanolorantsaina	fanoloran-tsaina
fanombohankase	fanombohan-kase
fanombohankasen	fanombohan-kasen
fanombohankasenao	fanombohan-kasenao
fanombohankaseny	fanombohan-kaseny
fanomezampahasoavana	fanomezam-pahasoavana
fanomezampitiavana	fanomezam-pitiavana
fanomezanjavatra	fanomezan-javatra
fanomezankanina	fanomezan-kanina
fanomezantsoa	fanomezan-tsoa
fanompoampanahy	fanompoam-panahy
fanompoampivavahana	fanompoam-pivavahana
fanompoampivavahany	fanompoam-pivavahany
fanompoanpivavahana	fanompoan-pivavahana
fanompoantsampy	fanompoan-tsampy
fanontanianjavatra	fanontanian-javatra
fanoratandaingan	fanoratan-daingan
fanorenamatezan	fanorena-matezan
fanorohampitiavana	fanoroham-pitiavana
fanozonampoana	fanozonam-poana
fantadralehilahy	fanta-dralehilahy
fantatrafa	fantatra-fa
fantsakandrano	fantsakan-drano
fantsombarahina	fantsom-barahina
farafarandrainy	farafaran-drainy
farafiainanay	fara-fiainanay
farafivoriana	fara-fivoriana
faramandimby	fara-mandimby
Faraohofra	Farao-hofra
Faraoneko	Farao-neko
faraorana	fara-orana
faratenin	fara-tenin
farateny	fara-teny
faravodiny	fara-vodiny
faritaniko	fari-taniko
faritanin	fari-tanin
faritaninao	fari-taninao
faritaninareo	fari-taninareo
faritanintsika	fari-tanintsika
faritaniny	fari-taniny
faritany	fari-tany
fasambahoaka	fasam-bahoaka
fasandRahely	fasan-dRahely
fasandrainy	fasan-drainy
fasandrazako	fasan-drazako
fatambary	fatam-bary
fatimaso	fati-maso
fatimosary	fati-mosary
fatindalitra	fatin-dalitra
fatindralehilahy	fatin-dralehilahy
fatinjavatra	fatin-javatra
fatinketaheta	fatin-ketaheta
fatintsabatra	fatin-tsabatra
fatranitady	fatra-nitady
fatrapahatsiaro	fatra-pahatsiaro
fatrapahihitra	fatra-pahihitra
fatrapamono	fatra-pamono
fatrapampionona	fatra-pampionona
Fatrapanao	Fatra-panao
fatrapanaraka	fatra-panaraka
fatrapaniry	fatra-paniry
fatrapiavonavona	fatra-piavonavona
fatrapifaly	fatra-pifaly
fatrapihevitra	fatra-pihevitra
fatrapijangajanga	fatra-pijangajanga
fatrapikatsaka	fatra-pikatsaka
fatrapikikitra	fatra-pikikitra
fatrapila	fatra-pila
fatrapirehareha	fatra-pirehareha
fatrapitady	fatra-pitady
fatrapitana	fatra-pitana
fatrapitàna	fatra-pitàna
fatrapitandrina	fatra-pitandrina
fatrapitia	fatra-pitia
Fatrapitia	Fatra-pitia
fatrapivavaka	fatra-pivavaka
fefilamban	fefi-lamban
fehiloha	fehi-loha
fehimbava	fehim-bava
fehimpaty	fehim-paty
fehimpihavanana	fehim-pihavanana
fehinkapa	fehin-kapa
fehinkapany	fehin-kapany
fehinkeloka	fehin-keloka
fehinkibo	fehin-kibo
fehinkibon	fehin-kibon
fehinkibonao	fehin-kibonao
fehinkibonareo	fehin-kibonareo
fehinkibony	fehin-kibony
fehintanana	fehin-tanana
fehintongony	fehin-tongony
fehintongotra	fehin-tongotra
fehintsabany	fehin-tsabany
fenovolana	feno-volana
feomboromailala	feom-boromailala
feondiona	feon-diona
feondokanga	feon-dokanga
feondrazazavavy	feon-drazazavavy
feontsodina	feon-tsodina
fetaona	fe-taona
fiadanampo	fiadanam-po
fiadiamandoza	fiadia-mandoza
fiadiankevitra	fiadian-kevitra
fiadianteny	fiadian-teny
fiahiahiandratsy	fiahiahian-dratsy
fiainambaovao	fiainam-baovao
fiainantsihita	fiainan-tsi-hita
Fiainantsihita	Fiainan-tsi-hita
fialantsasatra	fialan-tsasatra
fialantsiny	fialan-tsiny
fianakaviandrainy	fianakavian-drainy
fianakaviandreniny	fianakavian-dreniny
fiandohampahalalana	fiandoham-pahalalana
fiandohampahendrena	fiandoham-pahendrena
fiandrasanondry	fiandrasan-ondry
fiandrianandrainy	fiandrianan-drainy
fiangonandehibe	fiangonan-dehibe
fianianantsy	fianianan-tsy
fiantsoampiangonana	fiantsoam-piangonana
fiarovandoha	fiarovan-doha
fiarovandranjo	fiarovan-dranjo
fiarovantena	fiarovan-tena
fiarovantenany	fiarovan-tenany
fiarovantratra	fiarovan-tratra
fiarovantratrany	fiarovan-tratrany
fietrentena	fietren-tena
fietrentenantsika	fietren-tenantsika
fifadiankanina	fifadian-kanina
fifadiankaniny	fifadian-kaniny
fifanateranjavatra	fifanateran-javatra
fifanomezamboninahitra	fifanomezam-boninahitra
fihadiambato	fihadiam-bato
fihadiantany	fihadian-tany
fihadiataniny	fihadia-taniny
fihantonampiadiana	fihantonam-piadiana
fihantonanjavatra	fihantonan-javatra
fihaonandranomasina	fihaonan-dranomasina
fiharandoza	fiharan-doza
Fihariankarena	Fiharian-karena
fihatsarambelatsihin	fihatsaram-belatsihin
fihatsarambelatsihiny	fihatsaram-belatsihiny
fihatsarambelatsihy	fihatsaram-belatsihy
fihazonambohavoha	fihazonam-bohavoha
fihifikifihandoha	fihifikifihan-doha
fihinamboa	fihinam-boa
fihinambolon	fihinam-bolon
fihinampanahy	fihinam-panahy
fihinanambilon	fihinanam-bilon
fihinanambilona	fihinanam-bilona
fihinanankanina	fihinanan-kanina
fihinanankena	fihinanan-kena
fihinandamba	fihinan-damba
fihinandrainy	fihinan-drainy
fihinankanina	fihinan-kanina
fihirambaovao	fihiram-baovao
fihoabavany	fihoa-bavany
fihobiampamonjena	fihobiam-pamonjena
fijinjambary	fijinjam-bary
fikitrohanify	fikitroha-nify
fikodiadiankalesy	fikodiadian-kalesy
fikosohambary	fikosoham-bary
filalaovandratsy	filalaovan-dratsy
filandratsy	filan-dratsy
filanjavatra	filan-javatra
filankarena	filan-karena
filantangy	filan-tangy
filazampahoriana	filazam-pahoriana
filazandoza	filazan-doza
filazandravehivavy	filazan-dravehivavy
filazantsoa	filazan-tsoa
fileondivay	fileon-divay
fiotazamboalobok	fiotazam-boalobok
fiotazamboankazo	fiotazam-boankazo
firaisankina	firaisan-kina
firaisantetiky	firaisan-tetiky
firandranambolo	firandranam-bolo
firavabolamena	firava-bolamena
firehetampo	firehetam-po
firenenkafa	firenen-kafa
firenentsamy	firenen-tsamy
fisainampihavanana	fisainam-pihavanana
fisaorambady	fisaoram-bady
fisikinambolamena	fisikinam-bolamena
fisotroandivay	fisotroan-divay
fisotroandrano	fisotroan-drano
fisotroantoaka	fisotroan-toaka
fisotrompanahy	fisotrom-panahy
fitafiambehivavy	fitafiam-behivavy
fitafiandehilahy	fitafian-dehilahy
fitahiampanahy	fitahiam-panahy
fitantarampirazanana	fitantaram-pirazanana
fitarainampoana	fitarainam-poana
fitehenantanana	fitehenan-tanana
fitehirizambary	fitehirizam-bary
fitehirizampandriana	fitehirizam-pandriana
fitehirizampiadiana	fitehirizam-piadiana
fitehirizandrakiny	fitehirizan-drakiny
fitehirizandrakitra	fitehirizan-drakitra
fitehirizantaratasy	fitehirizan-taratasy
fitehirizantsoa	fitehirizan-tsoa
fitenenandratsy	fitenenan-dratsy
fiterahanjaza	fiterahan-jaza
fitiavambola	fitiavam-bola
fitiavandrahalahy	fitiavan-drahalahy
fitiavantorimaso	fitiavan-torimaso
fitodiantsambo	fitodian-tsambo
fitoeramaizina	fitoera-maizina
fitoeramasin	fitoera-masin
fitoeramasinareo	fitoera-masinareo
fitoeramasintsika	fitoera-masintsika
fitoerambarinao	fitoeram-barinao
fitoerampahendrena	fitoeram-pahendrena
fitoerandavenona	fitoeran-davenona
fitoerandavenonjiro	fitoeran-davenon-jiro
fitoerandavenonjirony	fitoeran-davenon-jirony
fitoerandiloilo	fitoeran-diloilo
fitoerandiloilony	fitoeran-diloilony
fitoerandivainy	fitoeran-divainy
fitoerandivay	fitoeran-divay
fitoerandrano	fitoeran-drano
fitoerandranomaintin	fitoeran-dranomaintin
fitoerandranomainty	fitoeran-dranomainty
fitoerandranomanitra	fitoeran-dranomanitra
fitoerandranomasina	fitoeran-dranomasina
fitoerandranon	fitoeran-dranon
fitoerandrava	fitoeran-drava
fitoerandrononony	fitoeran-drononony
fitoeranjavatra	fitoeran-javatra
fitoerankalesy	fitoeran-kalesy
fitoerankanina	fitoeran-kanina
Fitoerankarandoha	Fitoeran-karan-doha
fitoerantavindrano	fitoeran-tavin-drano
fitoerantongony	fitoeran-tongony
fitoerantongotr	fitoeran-tongotr
fitoerantongotra	fitoeran-tongotra
fitoerantongotrao	fitoeran-tongotrao
fitoerantongotro	fitoeran-tongotro
fitomboankarena	fitomboan-karena
fitondrandrano	fitondran-drano
fitondranentanareo	fitondran-entanareo
fitondranentany	fitondran-entany
fitondrantena	fitondran-tena
fitondrantenako	fitondran-tenako
fitondrantenan	fitondran-tenan
fitondrantenanareo	fitondran-tenanareo
fitondrantenanay	fitondran-tenanay
fitondrantenany	fitondran-tenany
fitonjato	fiton-jato
fitopolo	fito-polo
Fitopolo	Fito-polo
fitorianteny	fitorian-teny
fitsapantoetra	fitsapan-toetra
fitsimponamboalobok	fitsimponam-boalobok
fitsimponamboaloboka	fitsimponam-boaloboka
fitsimpontsimponamboaloboka	fitsimpontsimponam-boaloboka
fitsofandrano	fitsofan-drano
fitsofantrompetra	fitsofan-trompetra
fivelezambary	fivelezam-bary
fivelomandratsy	fiveloman-dratsy
fivoriandrano	fivorian-drano
fizahantavan	fizahan-tavan
fizahantoetra	fizahan-toetra
fizarambava	fizaram-bava
fofombadiny	fofom-badiny
fofondrano	fofon-drano
fofondratsiny	fofon-dratsiny
fokompirenen	fokom-pirenen
fokompirenena	fokom-pirenena
fokompirenenareo	fokom-pirenenareo
fokompirenendRobena	fokom-pirenen-dRobena
fokompireneny	fokom-pireneny
folentika	fo-lentika
fombambehivavy	fombam-behivavy
fombampanahy	fombam-panahy
fombampanambadiany	fombam-panambadiany
fombampiainanao	fombam-piainanao
fombampivavahana	fombam-pivavahana
fombandrazany	fomban-drazany
fombiby	fom-biby
Fonenamasin	Fonena-masin
fonenandravehivavy	fonenan-dravehivavy
fonomboany	fonom-boany
fotoampiambenana	fotoam-piambenana
fotoampisakafoana	fotoam-pisakafoana
fotoampitiavana	fotoam-pitiavana
fotoampivavahana	fotoam-pivavahana
fotoampivavahanareo	fotoam-pivavahanareo
fotoampivavahany	fotoam-pivavahany
fotoampivavahina	fotoam-pivavahina
fotobolo	foto-bolo
fotopanasany	foto-panasany
fotopen	foto-pen
fotopeny	foto-peny
fototsandriko	foto-tsandriko
Gatahefera	Gata-hefera
Gatarimona	Gata-rimona
Gatrimona	Gat-rimona
Gerotakimama	Gerota-kimama
Gorenatada	Goren-atada
hafadrazany	hafa-drazany
hahafabaraka	hahafa-baraka
hahafapo	hahafa-po
hahafatinketaheta	hahafatin-ketaheta
hahafatondromaso	hahafa-tondromaso
hahafatsiny	hahafa-tsiny
haharaikitahotra	haharaiki-tahotra
haharezantsika	haharezan-tsika
hahatantsabatra	hahatan-tsabatra
hahavadimandry	hahavadi-mandry
hahavanomboa	hahavanom-boa
Hahavokabary	Hahavoka-bary
hahavokajavatra	hahavoka-javatra
hahazoambola	hahazoam-bola
hahelantsoratra	hahelan-tsoratra
hahitandoza	hahitan-doza
hahonontena	hahonon-tena
haingambava	haingam-bava
haingampandeha	haingam-pandeha
haingantongotra	haingan-tongotra
haintanety	hain-tanety
haitraitranjaza	haitraitran-jaza
halaimpanahy	halaim-panahy
halambaraka	halam-baraka
halatsadrà	halatsa-drà
halemempanahy	halemem-panahy
hamafihatokao	hamafi-hatokao
hamahankanina	hamahan-kanina
hamahantena	hamahan-tena
hamarindranomaso	hamarin-dranomaso
Hamatazoba	Hamata-zoba
hamelomaso	hamelo-maso
hametratanana	hametra-tanana
hamimaso	hami-maso
hamindrampo	hamindram-po
hamorampanahy	hamoram-panahy
hamorondainga	hamoron-dainga
hamoronkevidratsy	hamoron-kevi-dratsy
hamorontsaina	hamoron-tsaina
hampaharaikitahotra	hampaharaiki-tahotra
hampahasaropiaro	hampahasaro-piaro
hampakabady	hampaka-bady
hampanankarena	hampanan-karena
hampandoavinketra	hampandoavin-ketra
hampianarimpahalalana	hampianarim-pahalalana
hampiaramitoetra	hampiara-mitoetra
hampididoza	hampidi-doza
Hampididoza	Hampidi-doza
hampihinankanina	hampihinan-kanina
hampivadipo	hampivadi-po
hampodiana	ham-podiana
hanafatondromaso	hanafa-tondromaso
hanafatsiny	hanafa-tsiny
hanalamboady	hanalam-boady
hanambady	hanam-bady
hanambe	hanam-be
hanamboninahitra	hanam-boninahitra
hanampahafahana	hanam-pahafahana
hanampahataperana	hanam-pahataperana
hanampahefana	hanam-pahefana
hanampahoriana	hanam-pahoriana
hanampandosirana	hanam-pandosirana
Hanampiadanana	Hanam-piadanana
hanampifaliana	hanam-pifaliana
hanampitsaharana	hanam-pitsaharana
hanandova	hanan-dova
hanandraharaha	hanan-draharaha
hanandranjavatra	hanandran-javatra
hanandrapeo	hanandra-peo
hanandrariny	hanan-drariny
hanandratena	hanandra-tena
hananjanakalahy	hanan-janakalahy
hananjavamahory	hanan-java-mahory
hanankaja	hanan-kaja
hanankamonjy	hanan-kamonjy
hanankarena	hanan-karena
hanankavana	hanan-kavana
hanankeloka	hanan-keloka
hanankery	hanan-kery
hanantahotra	hanan-tahotra
hanantany	hanan-tany
hanantombo	hanan-tombo
hanantombomboninahitra	hanan-tombom-boninahitra
hanantsiny	hanan-tsiny
hanarampo	hanaram-po
hanasatena	hanasa-tena
hanavotena	hanavo-tena
handaharanteny	handaharan-teny
handahateny	handaha-teny
Handahateny	Handaha-teny
handatsadrà	handatsa-drà
handevozinjavatra	handevozin-javatra
handoavanketra	handoavan-ketra
handranitena	handrani-tena
hangalatety	hangala-tety
hanimamitaka	hani-mamitaka
hanimpihinany	hanim-pihinany
hanimpin	hanim-pin
hanimpiny	hanim-piny
hanimpy	hanim-py
haningotena	haningo-tena
haninjitanana	haninji-tanana
haninkelindralehilahy	hanin-kelin-dralehilahy
haninkohaniko	hanin-kohaniko
haninkohanina	hanin-kohanina
haninkohaniny	hanin-kohaniny
haninkotrana	hanin-kotrana
hanirianjavatra	hanirian-javatra
hanohontanana	hanohon-tanana
hanoletena	hanole-tena
hanolotena	hanolo-tena
hanoloteny	hanolo-teny
hanolotsaina	hanolo-tsaina
Hanomezampahendrena	Hanomezam-pahendrena
hanonompitaka	hanonom-pitaka
hanorinday	hanorin-day
hantsambato	hantsam-bato
harafesimbeny	harafesim-beny
Haramagedona	Hara-magedona
haratotarihina	harato-tarihina
haratsiampanahin	haratsiam-panahin
haratsiampanahiny	haratsiam-panahiny
haratsiampanahy	haratsiam-panahy
harembevava	harem-bevava
harenjazavavy	haren-jazavavy
haroharoampaharatsiana	haroharoam-paharatsiana
hasiankanina	hasian-kanina
hasianteny	hasian-teny
hatotongotro	hato-tongotro
hatsarampanahy	hatsaram-panahy
hatsarantarehin	hatsaran-tarehin
hatsarantarehinao	hatsaran-tarehinao
hatsarantarehiny	hatsaran-tarehiny
hatsarantarehy	hatsaran-tarehy
Hatsihamanatita	Hatsi-hamanatita
Hatsihamenokota	Hatsi-hamenokota
havalindrainao	havalin-drainao
havandrainao	havan-drainao
havandrainy	havan-drainy
havandreninao	havan-dreninao
havaozampanahy	havaozam-panahy
havokisampifaliana	havokisam-pifaliana
Havotajaïra	Havota-jaïra
hazandrano	hazan-drano
Hazaradara	Hazar-adara
Hazaragada	Hazara-gada
Hazarasoala	Hazara-soala
Hazarasosa	Hazara-sosa
Hazarenana	Hazar-enana
Hazazontamara	Hazazon-tamara
Hazezontamara	Hazezon-tamara
Hazorahadata	Hazora-hadata
Hazorasosima	Hazora-sosima
Helkatahazorima	Helkata-hazorima
helodrainy	helo-drainy
helodrano	helo-drano
helodreniny	helo-dreniny
henankisoa	henan-kisoa
henidoza	heni-doza
Henjehindoza	Henjehin-doza
Herimbato	Herim-bato
herimby	herim-by
herimpo	herim-po
herintanana	herin-tanana
herintsandry	herin-tsandry
hetahetandrano	hetahetan-drano
hetinjiro	hetin-jiro
hetinjirony	hetin-jirony
hevidiso	hevi-diso
hevidratsinao	hevi-dratsinao
hevidratsiny	hevi-dratsiny
hevidratsy	hevi-dratsy
hevidravina	hevi-dravina
hevipanahy	hevi-panahy
hevipoana	hevi-poana
Hevipoana	Hevi-poana
hianiantsy	hianian-tsy
hiarabelona	hiara-belona
hiaradavo	hiara-davo
hiarakomana	hiara-komana
hiaramahita	hiara-mahita
hiaramamabo	hiara-mamabo
hiaramamantatra	hiara-mamantatra
hiaramaminany	hiara-maminany
hiaramanafika	hiara-manafika
hiaramanamboninahitra	hiara-manam-boninahitra
hiaramanandratra	hiara-manandratra
hiaramanao	hiara-manao
hiaramandeha	hiara-mandeha
hiaramandova	hiara-mandova
hiaramandray	hiara-mandray
hiaramandry	hiara-mandry
hiaramaniry	hiara-maniry
hiaramanjaka	hiara-manjaka
hiaramaty	hiara-maty
hiaramiakatra	hiara-miakatra
hiaramiampatra	hiara-miampatra
hiaramidìna	hiara-midìna
hiaramiditra	hiara-miditra
Hiaramierona	Hiara-mierona
hiaramiezaka	hiara-miezaka
hiaramifaly	hiara-mifaly
hiaramihevitra	hiara-mihevitra
hiaramihinana	hiara-mihinana
hiaramihinankanina	hiara-mihinan-kanina
hiaramihoby	hiara-mihoby
hiaramihomehy	hiara-mihomehy
hiaramiloka	hiara-miloka
hiaramipetraka	hiara-mipetraka
hiaramisaina	hiara-misaina
hiaramisakafo	hiara-misakafo
hiaramisalahy	hiara-misalahy
hiaramiseho	hiara-miseho
hiaramita	hiara-mita
hiaramitoetra	hiara-mitoetra
hiaramitondra	hiara-mitondra
hiaramitsangana	hiara-mitsangana
hiaramivavaka	hiara-mivavaka
hiaramiverina	hiara-miverina
Hiaramiverina	Hiara-miverina
hiaramivoaka	hiara-mivoaka
hiaramivory	hiara-mivory
hiaramonina	hiara-monina
hiaratafintohina	hiara-tafintohina
hiaratonga	hiara-tonga
hiasantany	hiasan-tany
hidimbavahadinao	hidim-bavahadinao
hidintrano	hidin-trano
hidirandoza	hidiran-doza
hieritreridratsy	hieritreri-dratsy
hifampihazontanana	hifampihazon-tanana
hifanaratsaina	hifanara-tsaina
hifanatijavatra	hifanati-javatra
Hifonjato	Hifon-jato
hiharampahoriana	hiharam-pahoriana
hiharandoza	hiharan-doza
hihetsehany	hihetseha-ny
hihifikifidoha	hihifikifi-doha
hihinamololo	hihina-mololo
hihinankanina	hihinan-kanina
hihinankena	hihinan-kena
Hihinankena	Hihinan-kena
hihinanofo	hihina-nofo
hihirimbelona	hihirim-belona
Hihoapampana	Hihoa-pampana
hihombombava	hihombom-bava
hikatombava	hikatom-bava
hiloabava	hiloa-bava
Hiloabava	Hiloa-bava
hipaibato	hipai-bato
Hiramaby	Hiram-aby
hirampanambadiana	hiram-panambadiana
hirindrimbaravarana	hirindrim-baravarana
hisaobady	hisao-bady
hisaratsaina	hisara-tsaina
Hisaratsaina	Hisara-tsaina
hisarombava	hisarom-bava
hisarompe	hisarom-pe
hisarondoha	hisaron-doha
hisokabava	hisoka-bava
hitaingintsoavaly	hitaingin-tsoavaly
hitampimaso	hitampi-maso
hitampimbava	hitampim-bava
Hitampimbava	Hitampim-bava
hitandRahely	hitan-dRahely
hitandralehilahy	hitan-dralehilahy
hitandravehivavy	hitan-dravehivavy
hitaridalana	hitari-dalana
hitehatanana	hiteha-tanana
Hitehatanana	Hiteha-tanana
hitehatratra	hiteha-tratra
hitehintanana	hitehin-tanana
hitenenandratsy	hitenenan-dratsy
hiterajaza	hitera-jaza
hitoejaza	hitoe-jaza
hitoerandravehivavy	hitoeran-dravehivavy
hitombandahy	hitomban-dahy
hitorabato	hitora-bato
hitorajofo	hitora-jofo
hitoriteny	hitori-teny
Hitoriteny	Hitori-teny
hitsahamiteny	hitsaha-miteny
hitsimpo	hitsim-po
hitsimpoko	hitsim-poko
hitsimponao	hitsim-ponao
hitsimpony	hitsim-pony
hitsoateny	hitsoa-teny
hitsodrano	hitso-drano
hivadipo	hivadi-po
hivarotena	hivaro-tena
hivoaramena	hivoara-mena
hizahantoetra	hizahan-toetra
hodiavintongotr	hodiavin-tongotr
hodimandry	hodi-mandry
hodimasoko	hodi-masoko
hodimasony	hodi-masony
hoditakasy	hodi-takasy
hoditray	hodi-tray
hofefin	ho-fefin
hofongorona	hofongoro-na
hokasihinkareza	hokasihin-kareza
holavontsabatra	holavon-tsabatra
homamaizina	homa-maizina
homamaraina	homa-maraina
homambe	homam-be
Homandavenona	Homan-davenona
homandremby	homan-dremby
homandrivotra	homan-drivotra
Homanjavatra	Homan-javatra
homankanina	homan-kanina
homankely	homan-kely
homemboninahitra	homem-boninahitra
homendronono	homen-dronono
homentsiny	homen-tsiny
Horahagidgada	Hora-hagidgada
horaisintanana	horaisin-tanana
horohorontany	horohoron-tany
horonamboky	horonam-boky
horonantaratasy	horonan-taratasy
hosamborintanana	hosamborin-tanana
hosaronankenatra	hosaronan-kenatra
hosasandrano	hosasan-drano
hotampenambava	hotampenam-bava
hotetezintsabatra	hotetezin-tsabatra
hotorahambato	hotoraham-bato
hovaliantsabatra	hovalian-tsabatra
hovaliantsoa	hovalian-tsoa
hovonointsabatra	hovonoin-tsabatra
hozahantoetra	hozahan-toetra
ialandremby	ialan-dremby
iarahamanaiky	iaraha-manaiky
iaretanareo	iaretanareo-
idirandoza	idiran-doza
Idirandoza	Idiran-doza
Ieabarima	Ie-abarima
ilaatiny	ila-atiny
ilampitia	ilam-pitia
ilaozamihodìna	ilaoza-mihodìna
ilasomony	ila-somony
ilatenany	ila-tenany
imasondrainy	imason-drainy
impito	im-pito
impolo	im-polo
indimampolon	indimam-polon
indimanjaton	indiman-jaton
indimanjatony	indiman-jatony
indraimbava	indraim-bava
inefapolo	inefa-polo
intelo	in-telo
intelopolo	intelo-polo
ipetrahandravehivavy	ipetrahan-dravehivavy
Iraharesa	Ira-haresa
iraidia	irai-dia
Iraidia	Irai-dia
irainjehy	irain-jehy
Irasemesy	Ira-semesy
Irnahasa	Ir-nahasa
isamaraina	isa-maraina
Isamaraina	Isa-maraina
isambantotr	isam-bantotr
isambatan	isam-batan
isambatana	isam-batana
isambavahadin	isam-bavahadin
isambavahady	isam-bavahady
isambohitra	isam-bohitra
isambolana	isam-bolana
isampanatitra	isam-panatitra
isampianakavian	isam-pianakavian
isampianakaviana	isam-pianakaviana
isampianakaviany	isam-pianakaviany
isampiangonana	isam-piangonana
isampirazanany	isam-pirazanany
isampirenena	isam-pirenena
isampireneny	isam-pireneny
isampito	isam-pito
Isampito	Isam-pito
isampokon	isam-pokon
isampokony	isam-pokony
isampotony	isam-potony
isandahy	isan-dahy
isandimampolo	isan-dimam-polo
isandimanjato	isan-diman-jato
isandroanjato	isan-droanjato
isanefaha	isan-efaha
isanefitrano	isan-efi-trano
isanjanak	isan-janak
isanjanakazo	isan-janakazo
isanjanako	isan-janako
isanjato	isan-jato
isanjoron	isan-joron
isankafitoana	isan-kafitoana
isankafoloana	isan-kafoloana
isankarazany	isan-karazany
isankariva	isan-kariva
Isankariva	Isan-kariva
isankateloana	isan-kateloana
isankerinandro	isan-kerinandro
isankerintaona	isan-kerintaona
isankerobima	isan-kerobima
isanolona	isan-olona
isanomby	isan-omby
isanondrilahy	isan-ondrilahy
isantanana	isan-tanana
isantanàna	isan-tanàna
isantaona	isan-taona
isantelo	isan-telo
isantoerana	isan-toerana
isantoko	isan-toko
isantokony	isan-tokony
isantonony	isan-tonony
isantotony	isan-totony
isantrano	isan-trano
isantranony	isan-tranony
isantsabata	isan-tsabata
isantSabata	isan-tSabata
IsantSabata	Isan-tSabata
Itakazina	Ita-kazina
itambesaran	itambesa-ran
itambesarankeloka	itambesaran-keloka
izany	iza-ny
izaodia	izao-dia
Jabesigileada	Jabesi-gileada
Jareoregima	Jare-oregima
Jasobilehema	Jasobi-lehema
Jebesigileada	Jebesi-gileada
Jegarasahadota	Jegara-sahadota
Jehovahjire	Jehovah-jire
Jehovahsaloma	Jehovah-saloma
Jiftaela	Jifta-ela
Josabaheseda	Josaba-heseda
Josebabasebeta	Joseba-basebeta
Kadesibarnea	Kadesi-barnea
Kadesinaftaly	Kadesi-naftaly
Kaisariafilipo	Kaisaria-filipo
Kalebaefrata	Kaleba-efrata
kalesimpamonjenao	kalesim-pamonjenao
kambandroa	kamban-droa
kapitenintsambo	kapitenin-tsambo
kapobava	kapo-bava
karandohany	karan-dohany
karazambiby	karazam-biby
karazamboaloboka	karazam-boaloboka
kavimbolamena	kavim-bolamena
Kavimbolamena	Kavim-bolamena
Kefarahamony	Kefara-hamony
Kerenahapoka	Kerena-hapoka
Keriotahezrona	Keriota-hezrona
kibondravehivavy	kibon-dravehivavy
Kibrotahatava	Kibrota-hatava
Kinatahozota	Kinata-hozota
Kiraharesa	Kira-haresa
Kiramoaba	Kira-moaba
Kiriatabala	Kiriata-bala
Kiriataima	Kiria-taima
Kiriatajearima	Kiriata-jearima
KiriataJearima	Kiriata-Jearima
Kiriatarba	Kiriat-arba
Kiriatarima	Kiriat-arima
Kiriatasefera	Kiriata-sefera
kitampombola	kitampom-bola
kitapombatsy	kitapom-batsy
kitapombola	kitapom-bola
kitapombolantsika	kitapom-bolantsika
kitrontsoavaliny	kitron-tsoavaliny
kitrontsoavaly	kitron-tsoavaly
kobambary	kobam-bary
kodiankalesy	kodian-kalesy
kofehindaiko	kofehin-daiko
kofehindainy	kofehin-dainy
Kolahoze	Kola-hoze
kopadroa	kopa-droa
korontambato	korontam-bato
Kosanrisataima	Kosan-risataima
lafintrano	lafin-trano
lahatenin	laha-tenin
lahateny	laha-teny
lahindrano	lahin-drano
lahindranon	lahin-dranon
lahindranony	lahin-dranony
lahinjiro	lahin-jiro
lakandrano	lakan-drano
lakandranony	lakan-dranony
lakanjozoro	lakan-jozoro
lalamahitsin	lala-mahitsin
lalamahitsy	lala-mahitsy
lalamalama	lala-malama
lalambe	lalam-be
Làlampahendrena	Làlam-pahendrena
lalampamonjena	lalam-pamonjena
lalampiadanana	lalam-piadanana
lalampitaka	lalam-pitaka
lalandrainy	lalan-drainy
lalandrano	lalan-drano
lalandranomasina	lalan-dranomasina
lalandratsinareo	lalan-dratsinareo
lalàndratsinareo	lalàn-dratsinareo
lalandratsiny	lalan-dratsiny
lalandratsy	lalan-dratsy
lalàndratsy	lalàn-dratsy
lalàndreninao	lalàn-dreninao
lalankafa	lalan-kafa
lalankafitoana	lalan-kafitoana
lalankaleha	lalan-kaleha
lalankalehako	lalan-kalehako
lalankalehan	lalan-kalehan
lalankalehanao	lalan-kalehanao
lalankalehanareo	lalan-kalehanareo
lalankalehany	lalan-kalehany
lalankateloana	lalan-kateloana
lalàntenany	lalàn-tenany
lalantsara	lalan-tsara
lalantsarany	lalan-tsarany
lalintsaina	lalin-tsaina
lambampandriana	lambam-pandriana
lambampaty	lambam-paty
lambanandamba	lambanan-damba
lambanjaza	lamban-jaza
lambantsoavaly	lamban-tsoavaly
lamboridintsoavaly	lamboridin-tsoavaly
lanimpisentoana	lanim-pisentoana
lanintsabatra	lanin-tsabatra
lanjantalenta	lanjan-talenta
lanjantsekely	lanjan-tsekely
lasandavitra	lasan-davitra
lasanko	lasan-ko
Lasanko	Lasan-ko
latsadanja	latsa-danja
latsadrà	latsa-drà
lavabary	lava-bary
lavabato	lava-bato
lavatany	lava-tany
lavatsira	lava-tsira
lavenombantotr	lavenom-bantotr
lavonkeloka	lavon-keloka
lavontsabatra	lavon-tsabatra
Lebakamay	Leba-kamay
lefompohy	lefom-pohy
lelafamaky	lela-famaky
lelalefony	lela-lefony
lelantsabatra	lelan-tsabatra
lelavaravaran	lela-varavaran
lelavaravarana	lela-varavarana
lelavaravarany	lela-varavarany
lelavavahadin	lela-vavahadin
lelavavahadiny	lela-vavahadiny
lelavavahady	lela-vavahady
lendranomaso	len-dranomaso
leondivay	leon-divay
Leondivay	Leon-divay
levonko	levon-ko
Liankanina	Lian-kanina
liombavy	liom-bavy
liondahy	lion-dahy
loajafy	loa-jafy
Lòamy	Lò-amy
Lodebara	Lo-debara
lohakororoky	loha-kororoky
lohalalana	loha-lalana
lohalalanao	loha-lalanao
lohalalany	loha-lalany
lohamboriky	loham-boriky
lohampirenen	loham-pirenen
lohampirenena	loham-pirenena
lohampirenenareo	loham-pirenenareo
lohampireneny	loham-pireneny
lohaorana	loha-orana
loharanompamonjena	loharanom-pamonjena
loharanondranomasina	loharanon-dranomasina
loharanondranomaso	loharanon-dranomaso
loharindrina	loha-rindrina
lohasahampaty	lohasaham-paty
lohasahandriak	lohasahan-driak
lohasahandriaka	lohasahan-driaka
Lohasahandriaka	Lohasahan-driaka
lohasahandriakanao	lohasahan-driakanao
lohasahandriaky	lohasahan-driaky
lohasahantsira	lohasahan-tsira
Lohasahantsira	Lohasahan-tsira
lohasambo	loha-sambo
lohatehina	loha-tehina
lohatehiny	loha-tehiny
lolompo	lolom-po
Lòrohama	Lò-rohama
madipo	madi-po
Magoramisabiba	Magora-misabiba
mahafabaraka	mahafa-baraka
mahafabohitra	mahafa-bohitra
mahafaboninahitra	mahafa-boninahitra
mahafapo	mahafa-po
mahafatahotra	mahafa-tahotra
mahafatondromaso	mahafa-tondromaso
mahafihimbava	mahafihim-bava
mahafintena	mahafin-tena
mahaloabava	mahaloa-bava
mahaloapeo	mahaloa-peo
mahambimbava	mahambim-bava
mahamisy	maha-misy
mahampodranomaso	mahampo-dranomaso
Mahanedana	Mahane-dana
maharaikitahotra	maharaiki-tahotra
maharipo	mahari-po
Maharipo	Mahari-po
mahasaropiaro	mahasaro-piaro
mahasondriantory	mahasondrian-tory
mahatafatoetra	maha-tafatoetra
mahatandrano	mahatan-drano
mahatandrintena	mahatandrin-tena
mahatantsabatra	mahatan-tsabatra
mahatapataolana	mahatapa-taolana
mahataridalana	mahatari-dalana
mahatehijery	mahate-hijery
mahatehijery	maha-te-hijery
mahatehizaha	maha-te-hizaha
mahatehotia	mahate-ho-tia
mahatehotia	maha-te-ho-tia
mahatoky	maha-toky
mahavanomboa	mahavanom-boa
mahavinantoko	maha-vinantoko
mahavokatsoa	mahavoka-tsoa
mahazakantsambonao	mahazakan-tsambonao
mahazakantsariety	mahazakan-tsariety
mahazanany	maha-zanany
Maherasalalahasibaza	Mahera-salala-hasi-baza
mahiratsaina	mahira-tsaina
mahonompo	mahonom-po
mahonontena	mahonon-tena
maimaimpoana	maimaim-poana
maintenda	main-tenda
maivamboa	maivam-boa
maizimpito	maizim-pito
maizintsaina	maizin-tsaina
malaimiteny	malai-miteny
malainkandeha	malain-kandeha
malainko	malain-ko
mamahantena	mamahan-tena
Mamandrapeo	Mamandra-peo
mamantajavatra	mamanta-javatra
mamarindranomaso	mamarin-dranomaso
mamelapandrika	mamela-pandrika
Mamelapandrika	Mamela-pandrika
mamelomaso	mamelo-maso
mametratanana	mametra-tanana
mamimaso	mami-maso
mamitatena	mamita-tena
Mamoapeo	Mamoa-peo
mamondivay	mamon-divay
mamondrà	mamon-drà
mamorompitaka	mamorom-pitaka
mamoronkeloka	mamoron-keloka
mamoronkevidratsy	mamoron-kevi-dratsy
mamorontsaina	mamoron-tsaina
mamorontsaindratsy	mamoron-tsain-dratsy
Mamorontsaindratsy	Mamoron-tsain-dratsy
mampahasaropiaro	mampahasaro-piaro
Mampahasaropiaro	Mampahasaro-piaro
mampakabady	mampaka-bady
mampanankarena	mampanan-karena
Mampiaritory	Mampiari-tory
mampididoza	mampidi-doza
mampikotrokotropeo	mampikotrokotro-peo
mampisambobola	mampisambo-bola
mampisambojavatra	mampisambo-javatra
mampivadipo	mampivadi-po
manadindrà	manadin-drà
manafimpitaka	manafim-pitaka
manafinjavatra	manafin-javatra
manafintava	manafin-tava
manafintena	manafin-tena
manaikitraikimolotra	manaikitraiki-molotra
manakopery	manako-pery
manalabaraka	manala-baraka
Manalabaràtena	Manala-barà-tena
manamanana	mana-manana
manamaso	mana-maso
Manamaso	Mana-maso
manambady	manam-bady
Manambady	Manam-bady
Manambava	Manam-bava
manambe	manam-be
Manambe	Manam-be
manamboa	manam-boa
manambola	manam-bola
manambolamena	manam-bolamena
manamelotena	manamelo-tena
manamitrano	manami-trano
manamnofonaina	manam-nofonaina
manampahadisoana	manam-pahadisoana
manampahalalana	manam-pahalalana
manampahamasinana	manam-pahamasinana
manampahataperana	manam-pahataperana
manampahefana	manam-pahefana
manampahelana	manam-pahelana
manampahendrena	manam-pahendrena
Manampahoriana	Manam-pahoriana
manampaka	manam-paka
manampamonjena	manam-pamonjena
manampanahy	manam-panahy
manampananana	manam-pananana
manampanapaka	mana-mpanapaka
manampanjaka	mana-mpanjaka
manampara	manam-para
manampialofana	manam-pialofana
manampijanonana	manam-pijanonana
manampingotra	manam-pingotra
manampinoana	manam-pinoana
manampiovana	manam-piovana
manampitiavana	manam-pitiavana
manampitoviana	manam-pitoviana
manampitsaharana	manam-pitsaharana
manampofonaina	manam-pofonaina
manamponenana	manam-ponenana
mananabady	manana-bady
mananamana	mana-namana
mananapiarovantratra	manana-piarovan-tratra
manandamba	manan-damba
manandavaka	manan-davaka
manandaza	manan-daza
manandehibe	manan-dehibe
manandoha	manan-doha
manandova	manan-dova
manandrahalahy	manan-drahalahy
manandraharaha	manan-draharaha
manandrambo	manan-drambo
manandrapeo	manandra-peo
manandrariny	manan-drariny
manandratanana	manandra-tanana
manandratandroka	manandra-tandroka
manandratena	manandra-tena
manandray	manan-dray
Manandray	Manan-dray
manandreny	manan-dreny
manangantanana	manangan-tanana
manangantsaho	manangan-tsaho
manangonkitay	manangon-kitay
mananjanaka	manan-janaka
mananjanakalahy	manan-janakalahy
mananjanakavavy	manan-janakavavy
Mananjara	Manan-jara
mananjavamahory	manan-java-mahory
mananjavatra	manan-javatra
mananjo	manan-jo
manankaja	manan-kaja
manankalahatra	manan-kalahatra
manankaloa	manan-kaloa
manankamonjy	manan-kamonjy
manankandova	manan-kandova
manankanina	manan-kanina
Manankanina	Manan-kanina
manankaninkohanina	manan-kanin-kohanina
manankarembevava	manan-karem-bevava
manankarena	manan-karena
Manankarena	Manan-karena
manankaterina	manan-katerina
manankavaly	manan-kavaly
Manankavaly	Manan-kavaly
manankavana	manan-kavana
manankeloka	manan-keloka
manankenatra	manan-kenatra
manankery	manan-kery
Manankery	Manan-kery
manankevidratsy	manan-kevi-dratsy
manankitafy	manan-kitafy
mananko	manan-ko
manankohanina	manan-kohanina
manankolazaina	manan-kolazaina
manantahiry	manan-tahiry
manantahotra	manan-tahotra
manantaloha	manan-taloha
manantanana	manan-tanana
Manantanana	Manan-tanana
manantandroka	manan-tandroka
mananteny	manan-teny
manantombo	manan-tombo
manantombompisandratana	manan-tombom-pisandratana
manantombonkery	manan-tombon-kery
manantompo	manan-tompo
manantongotra	manan-tongotra
Manantongotra	Manan-tongotra
manantrano	manan-trano
manantrosa	manan-trosa
manantsabatra	manan-tsabatra
manantsain	manan-tsain
manantsaina	manan-tsaina
manantsambo	manan-tsambo
Manantsandry	Manan-tsandry
manantsiny	manan-tsiny
manantsofina	manan-tsofina
Manantsofina	Manan-tsofina
Manaoveloma	Manao-veloma
manaradrindrina	manara-drindrina
manarampo	manaram-po
manarompitahiana	manarom-pitahiana
manarondrahona	manaron-drahona
manaronkeloka	manaron-keloka
manasatena	manasa-tena
manatadrano	manata-drano
mandahateny	mandaha-teny
mandatsadrà	mandatsa-drà
mandatsadrakitra	mandatsa-drakitra
mandatsadranomaso	mandatsa-dranomaso
mandatsadremby	mandatsa-dremby
mandositsabatra	mandosi-tsabatra
mandrakariva	mandra-kariva
mandranitena	mandrani-tena
mandrapahadiony	mandra-pahadiony
mandrapahafakay	mandra-pahafakay
mandrapahafaky	mandra-pahafaky
mandrapahafampanan	mandra-pahafampanan
mandrapahafanan	mandra-pahafanan
mandrapahafantany	mandra-paha-fantany
mandrapahafantatrao	mandra-pahafantatrao
mandrapahafapony	mandra-pahafa-pony
mandrapahafatiko	mandra-pahafatiko
mandrapahafatin	mandra-pahafatin
mandrapahafatinareo	mandra-pahafatinareo
mandrapahafatintsika	mandra-pahafatintsika
mandrapahafatiny	mandra-pahafatiny
mandrapahafenon	mandra-pahafenon
Mandrapahafoan	Mandra-pahafoan
Mandrapahafoanan	Mandra-pahafoanan
mandrapahafotsy	mandra-pahafotsy
mandrapahalanin	mandra-pahalanin
mandrapahalaninao	mandra-pahalaninao
mandrapahalaniny	mandra-pahalaniny
mandrapahalany	mandra-pahalany
mandrapahalàny	mandra-pahalàny
mandrapahalasan	mandra-pahalasan
Mandrapahalasan	Mandra-pahalasan
mandrapahalehiben	mandra-pahalehiben
mandrapahalehibeny	mandra-pahalehibeny
mandrapahaleonareo	mandra-pahaleonareo
mandrapahalevon	mandra-pahalevon
mandrapahalin	mandra-pahalin
mandrapahaloadrà	mandra-pahaloa-drà
mandrapahamamatonalina	mandra-paha-mamatonalina
mandrapahamarain	mandra-pahamarain
mandrapahamaraina	mandra-pahamaraina
mandrapahamaronao	mandra-pahamaronao
mandrapahantitrareo	mandra-pahantitrareo
mandrapahantitro	mandra-pahantitro
mandrapaharesiny	mandra-paharesiny
mandrapaharin	mandra-paharin
mandrapaharingan	mandra-paharingan
mandrapaharinganao	mandra-paharinganao
mandrapaharingany	mandra-paharingany
mandrapaharitry	mandra-paharitry
mandrapaharivan	mandra-paharivan
mandrapahasitrany	mandra-pahasitrany
mandrapahatafitan	mandra-pahatafitan
mandrapahatanterak	mandra-pahatanterak
mandrapahatanteraky	mandra-pahatanteraky
mandrapahatapitry	mandra-pahatapitry
mandrapahatongako	mandra-pahatongako
mandrapahatongan	mandra-pahatongan
Mandrapahatongan	Mandra-pahatongan
mandrapahatonganao	mandra-pahatonganao
mandrapahatonganareo	mandra-pahatonganareo
mandrapahatonganay	mandra-pahatonganay
mandrapahatongantsika	mandra-pahatongantsika
mandrapahatongany	mandra-pahatongany
Mandrapahatongany	Mandra-pahatongany
mandrapahatoy	mandra-paha-toy
mandrapahatsihisy	mandra-paha-tsi-hisy
mandrapahatsy	mandra-paha-tsy
mandrapahaveriheviny	mandra-pahaveri-heviny
mandrapahavitan	mandra-pahavitan
mandrapahavitany	mandra-pahavitany
mandrapahavizan	mandra-pahavizan
mandrapahavokinareo	mandra-pahavokinareo
mandrapahazavan	mandra-pahazavan
mandrapahazon	mandra-pahazon
mandrapahazony	mandra-pahazony
mandrapahita	mandra-pahita
mandrapahitako	mandra-pahitako
Mandrapahitako	Mandra-pahitako
mandrapahitany	mandra-pahitany
mandrapahoviana	mandra-pahoviana
Mandrapahoviana	Mandra-pahoviana
mandrapamaliko	mandra-pamaliko
Mandrapamalin	Mandra-pamalin
mandrapamatonalina	mandra-pamatonalina
mandrapamboatray	mandra-pamboatray
mandrapamenony	mandra-pamenony
mandrapametraka	mandra-pametraka
Mandrapamindra	Mandra-pamindra
mandrapamindrany	mandra-pamindrany
mandrapampanatitrao	mandra-pampanatitrao
mandrapanafiana	mandra-panafiana
mandrapanaisony	mandra-panaisony
Mandrapanaisotr	Mandra-panaisotr
mandrapanaisotra	mandra-panaisotra
mandrapanaisotrareo	mandra-panaisotrareo
mandrapanaoko	mandra-panaoko
mandrapanaony	mandra-panaony
mandrapanatitra	mandra-panatitra
mandrapandaloko	mandra-pandaloko
mandrapandalon	mandra-pandalon
mandrapandànao	mandra-pandànao
mandrapandanianareo	mandra-pandanianareo
Mandrapandaniko	Mandra-pandaniko
mandrapandaniny	mandra-pandaniny
Mandrapandatsaka	Mandra-pandatsaka
mandrapandefako	mandra-pandefako
mandrapandevin	mandra-pandevin
mandrapandoany	mandra-pandoany
mandrapandravany	mandra-pandravany
mandrapandràvany	mandra-pandràvany
mandrapandringana	mandra-pandringana
mandrapandringanao	mandra-pandringanao
mandrapandringany	mandra-pandringany
mandrapandroakany	mandra-pandroakany
mandrapandronjinareo	mandra-pandronjinareo
Mandrapangatsiatsiaky	Mandra-pangatsiatsiaky
mandrapanisinay	mandra-panisinay
mandrapanjakan	mandra-panjakan
mandrapanomen	mandra-panomen
mandrapanonitry	mandra-panonitry
Mandrapanoriny	Mandra-panoriny
mandrapanotinao	mandra-panotinao
mandrapanotiny	mandra-panotiny
mandrapanoty	mandra-panoty
mandrapialàlan	mandra-pialàlan
Mandrapialan	Mandra-pialan
mandrapialanareo	mandra-pialanareo
mandrapiantrany	mandra-piantrany
mandrapidiny	mandra-pidiny
Mandrapiditro	Mandra-piditro
mandrapiditry	mandra-piditry
Mandrapifaliny	Mandra-pifaliny
mandrapihadiko	mandra-pihadiko
Mandrapihady	Mandra-pihady
mandrapihatry	mandra-pihatry
mandrapihaviko	mandra-pihaviko
Mandrapihaviko	Mandra-pihaviko
mandrapihavin	mandra-pihavin
mandrapihaviny	mandra-pihaviny
mandrapihevitrareo	mandra-pihevitrareo
mandrapihilan	mandra-pihilan
mandrapihinany	mandra-pihinany
mandrapijanony	mandra-pijanony
mandrapikaodikaodiny	mandra-pikaodikaodiny
mandrapilazako	mandra-pilazako
mandrapilazanareo	mandra-pilazanareo
mandrapilentiky	mandra-pilentiky
mandrapiposaky	mandra-piposaky
mandrapisehony	mandra-pisehony
mandrapisotrony	mandra-pisotrony
mandrapitadin	mandra-pitadin
mandrapitako	mandra-pitako
mandrapitanareo	mandra-pitanareo
mandrapitantsika	mandra-pitantsika
mandrapitany	mandra-pitany
mandrapitarikay	mandra-pitarikay
mandrapitataovovonan	mandra-pitataovovonan
mandrapiteliko	mandra-piteliko
mandrapiterany	mandra-piterany
mandrapitondrako	mandra-pitondrako
mandrapitondranay	mandra-pitondranay
mandrapitsangako	mandra-pitsangako
Mandrapitsangako	Mandra-pitsangako
mandrapitsangan	mandra-pitsangan
mandrapivavako	mandra-pivavako
mandrapiverin	mandra-piverin
mandrapiverinao	mandra-piverinao
mandrapiverinay	mandra-piverinay
mandrapiveriny	mandra-piveriny
mandrapivoakany	mandra-pivoakany
mandrepihavin	mandre-pihavin
mandrotsadranomaso	mandrotsa-dranomaso
manentsintadiny	manentsin-tadiny
mangirandratsy	mangiran-dratsy
maningotena	maningo-tena
maninjitàna	maninji-tàna
maninjitanana	maninji-tanana
manintsamboa	manintsam-boa
manipofona	mani-pofona
Manipofona	Mani-pofona
manjamasony	manja-masony
mankahàdoza	mankahà-doza
manohontanana	manohon-tanana
manolokoditra	manolo-koditra
manolopahalalana	manolo-pahalalana
manolotena	manolo-tena
manolotsaindratsy	manolo-tsain-dratsy
Manondradrano	Manondra-drano
manorinday	manorin-day
maraintsy	marain-tsy
mararimpitia	mararim-pitia
marevapitafiana	mareva-pitafiana
marikorikonkanina	marikorikon-kanina
maritrano	mari-trano
masiatarehy	masia-tarehy
masimbava	masim-bava
masombiko	masom-biko
masombolafotsy	masom-bolafotsy
masomby	masom-by
masondralehilahy	mason-dralehilahy
masondrano	mason-drano
matiila	mati-ila
matimpaniriana	matim-paniriana
matinjavamahatahotra	matin-java-mahatahotra
matinketaheta	matin-ketaheta
matintsabatra	matin-tsabatra
mavesadanja	mavesa-danja
mavesakeloka	mavesa-keloka
mbanjanany	mban-janany
Mejarkona	Me-jarkona
melodalana	melo-dalana
menamaso	mena-maso
Merodakabaladana	Merodaka-baladana
Mesekatobala	Meseka-tobala
Mezahaba	Me-zahaba
miadampiteny	miadam-piteny
mialintaona	mialin-taona
miambintompo	miambin-tompo
mianatsimoandrefana	mianatsimo-andrefana
mianavaratraandrefana	mianavaratra-andrefana
mianiantsy	mianian-tsy
miankindoha	miankin-doha
miantobahiny	mianto-bahiny
miantotrosa	mianto-trosa
miarabelona	miara-belona
miaradalana	miara-dalana
miaradavo	miara-davo
miaradia	miara-dia
miaradreraka	miara-dreraka
miarakomana	miara-komana
miaramaharitra	miara-maharitra
miaramamely	miara-mamely
miaramamory	miara-mamory
miaramanatsoboka	miara-manatsoboka
miaramandeha	miara-mandeha
miaramandroso	miara-mandroso
Miaramandroso	Miara-mandroso
miaramandry	miara-mandry
Miaramanodidina	Miara-manodidina
miaramarary	miara-marary
miaramaty	miara-maty
Miaramiadana	Miara-miadana
miaramiafina	miara-miafina
miaramiampatra	miara-miampatra
miaramiaritory	miara-miari-tory
miaramiaritra	miara-miaritra
miaramiasa	miara-miasa
miaramifaly	miara-mifaly
miaramifatotra	miara-mifatotra
miaramihazakazaka	miara-mihazakazaka
miaramihinana	miara-mihinana
Miaramihinana	Miara-mihinana
miaramihoby	miara-mihoby
miaramijaly	miara-mijaly
miaramilaza	miara-milaza
miaramioko	miara-mioko
miaramipetraka	miara-mipetraka
miaramisaina	miara-misaina
miaramisento	miara-misento
miaramisikìna	miara-misikìna
miaramitoetra	miara-mitoetra
miaramitomany	miara-mitomany
miaramitondra	miara-mitondra
miaramitoto	miara-mitoto
miaramivoaka	miara-mivoaka
miaramomba	miara-momba
miaramonina	miara-monina
miaratotoinao	miara-totoinao
miaritorintsaina	miari-torin-tsaina
miaritory	miari-tory
miavanavompanahy	miavanavom-panahy
miboediboedipiteny	miboediboedi-piteny
miendrijanak	miendri-janak
mieritreridratsy	mieritreri-dratsy
mifanapatsinay	mifanapa-tsinay
mifanarakevitra	mifanara-kevitra
mifanatrimaso	mifanatri-maso
mifodrano	mifo-drano
Migdalagada	Migdala-gada
miharabolombava	mihara-bolom-bava
mihetsijaza	mihetsi-jaza
Mihevidratsy	Mihevi-dratsy
mihifikifidoha	mihifikifi-doha
Mihifikifidoha	Mihifikifi-doha
mihinamboaloboka	mihinam-boaloboka
mihinandrà	mihinan-drà
mihinankanina	mihinan-kanina
mihinankena	mihinan-kena
mihintsambolondoha	mihintsam-bolon-doha
mihirimbelona	mihirim-belona
mihoapampana	mihoa-pampana
mihombombava	mihombom-bava
mihosimenaka	mihosi-menaka
mihosimpotaka	mihosim-potaka
mihosindrà	mihosin-drà
mihosinkosindavenona	mihosinkosin-davenona
mihosodiloilo	mihoso-diloilo
mijanondavitra	mijanon-davitra
mikasibehivavy	mikasi-behivavy
mikitronify	mikitro-nify
miloabava	miloa-bava
mindrambilany	mindram-bilany
mindranjavatra	mindran-javatra
miorimpaka	miorim-paka
mipetrapoana	mipetra-poana
mipibolo	mipi-bolo
mipimaso	mipi-maso
Mipotrapotradranomaso	Mipotrapotra-dranomaso
misaimpitaka	misaim-pitaka
misaindratsy	misain-dratsy
misaintsaindratsy	misaintsain-dratsy
misambodrivotra	misambo-drivotra
misaobady	misao-bady
misarakitro	misara-kitro
misarapandriana	misara-pandriana
misarondoha	misaron-doha
misaronkenatra	misaron-kenatra
Misrefotamaima	Misrefota-maima
mitainginkalesy	mitaingin-kalesy
mitaingintsoavaly	mitaingin-tsoavaly
Mitaingintsoavaly	Mitaingin-tsoavaly
mitampimaso	mitampi-maso
mitantsabatra	mitan-tsabatra
mitarehikolamena	mitarehi-kola-mena
mitarehimbolamena	mitarehim-bolamena
mitarehimboninkazo	mitarehim-boninkazo
Mitarehindelafo	Mitarehin-delafo
mitarehindrano	mitarehin-drano
Mitarehintsoavaly	Mitarehin-tsoavaly
mitaridalana	mitari-dalana
mitarikeloka	mitari-keloka
mitataovovonana	mitatao-vovonana
Mitehatanana	Miteha-tanana
mitehatratra	miteha-tratra
Mitehatratra	Miteha-tratra
mitehintanana	mitehin-tanana
miteradoza	mitera-doza
mitoejaza	mitoe-jaza
mitokamonina	mitoka-monina
mitombodoha	mitombo-doha
mitorabato	mitora-bato
mitsahanono	mitsaha-nono
Mitsangamenatra	Mitsanga-menatra
mitsangankanohitra	mitsangan-kanohitra
mitsidrà	mitsi-drà
mitsodrano	mitso-drano
mitsongodia	mitsongo-dia
Mitsongodia	Mitsongo-dia
mivadimandry	mivadi-mandry
mivadipo	mivadi-po
mivalonkotraka	mivalon-kotraka
mivarojanakavavy	mivaro-janakavavy
mivarotena	mivaro-tena
mivoaramena	mivoara-mena
mivoatsetroka	mivoa-tsetroka
mivolombarahina	mivolom-barahina
mivolonjaky	mivolon-jaky
modimandry	modi-mandry
mofompahoriana	mofom-pahoriana
mofondanitra	mofon-danitra
mofonjaza	mofon-jaza
morondranomasin	moron-dranomasin
morondranomasina	moron-dranomasina
morontongony	moron-tongony
morontongotr	moron-tongotr
morontongotry	moron-tongotry
mosaremofo	mosare-mofo
mpakafanahy	mpaka-fanahy
mpamandriborona	mpamandri-borona
mpamelondalana	mpamelon-dalana
mpaminanindrainao	mpaminanin-drainao
mpaminanindreninao	mpaminanin-dreninao
mpamorondainga	mpamoron-dainga
mpamorontsaindratsy	mpamoron-tsain-dratsy
mpampakabady	mpampaka-bady
mpampianadalàna	mpampiana-dalàna
mpanafatsiny	mpanafa-tsiny
mpanamarintena	mpanamarin-tena
Mpanaobatisa	Mpanao-batisa
mpanarampo	mpanaram-po
mpandahateny	mpandaha-teny
mpandatsabato	mpandatsa-bato
mpandatsadrà	mpandatsa-drà
mpandonkoditra	mpandon-koditra
mpanentsintsambonao	mpanentsin-tsambonao
mpanolotsaina	mpanolo-tsaina
Mpanolotsaina	Mpanolo-tsaina
mpanolotsainan	mpanolo-tsainan
mpanolotsainao	mpanolo-tsainao
mpanolotsainy	mpanolo-tsainy
mpanompondrainy	mpanompon-drainy
mpanompondralehilahy	mpanompon-dralehilahy
mpanompony	mpanom-pony
mpanondradrano	mpanondra-drano
mpanorabato	mpanora-bato
mpanoradalàna	mpanora-dalàna
mpanorindasy	mpanorin-dasy
mpianakavindraiko	mpianakavin-draiko
mpianakavindrainao	mpianakavin-drainao
mpianakavindrainy	mpianakavin-drainy
mpianiantsy	mpianian-tsy
mpiaramandova	mpiara-mandova
mpiaramiasa	mpiara-miasa
mpiaramifatotra	mpiara-mifatotra
mpihatsaravelatsihy	mpihatsaravela-tsihy
mpiombondray	mpiombon-dray
mpipaibato	mpipai-bato
mpisafotany	mpisafo-tany
mpitaingintsoa	mpitaingin-tsoa
mpitaingintsoavaliny	mpitaingin-tsoavaliny
mpitaingintsoavaly	mpitaingin-tsoavaly
mpitàmarika	mpità-marika
mpitandefona	mpitan-defona
mpitandridraharaha	mpitandri-draharaha
mpitantsabatra	mpitan-tsabatra
mpitondratena	mpitondra-tena
mpitoritenin	mpitori-tenin
mpivarobary	mpivaro-bary
nahafabaraka	nahafa-baraka
nahafatiantoka	naha-fatiantoka
nahafatondromaso	nahafa-tondromaso
nahafirenena	naha-firenena
naharaikitahotra	naharaiki-tahotra
naharinoana	nahari-noana
naharitory	nahari-tory
nahasaropiaro	nahasaro-piaro
nahasondriantory	nahasondrian-tory
nahatampiadiana	nahatam-piadiana
nahatandefona	nahatan-defona
nahatantsabatra	nahatan-tsabatra
nahavirijina	naha-virijina
nahimpony	nahim-pony
nahitandoza	nahitan-doza
nalaimpanahy	nalaim-panahy
nalaindRahely	nalain-dRahely
nalaindralehilahy	nalain-dralehilahy
nalaindravehivavy	nalain-dravehivavy
nalaindRebeka	nalain-dRebeka
nalainkandeha	nalain-kandeha
nalankapa	nalan-kapa
Nalantsarona	Nalan-tsarona
nalehandrainy	nalehan-drainy
namelapandrika	namela-pandrika
Namelapandrika	Namela-pandrika
namelonjaza	namelon-jaza
nametratanana	nametra-tanana
namihimbava	namihim-bava
Namorondainga	Namoron-dainga
namoronkevidratsy	namoron-kevi-dratsy
namoronkevitra	namoron-kevitra
namorontsaina	namoron-tsaina
namorontsaindratsy	namoron-tsain-dratsy
nampahasaropiaro	nampahasaro-piaro
Nampahasaropiaro	Nampahasaro-piaro
nampakabady	nampaka-bady
nampanankarena	nampanan-karena
nampiakarindravehivavy	nampiakarin-dravehivavy
nampianianandrainy	nampianianan-drainy
nampiantranoindravehivavy	nampiantranoin-dravehivavy
nampididoza	nampidi-doza
nampidirindralehilahy	nampidirin-dralehilahy
nampitsangambolo	nampitsangam-bolo
nanafimpandrika	nanafim-pandrika
nanakadrano	nanaka-drano
nanalabaraka	nanala-baraka
nanamarintena	nanamarin-tena
nanambady	nanam-bady
nanambe	nanam-be
nanambolo	nanam-bolo
nanampahazavana	nanam-pahazavana
nanampahefana	nanam-pahefana
nanampahendrena	nanam-pahendrena
nanampaka	nanam-paka
nanampanahy	nanam-panahy
nanampiadanana	nanam-piadanana
nanampiarovantratra	nanam-piarovan-tratra
nanampimaso	nanampi-maso
nanampinoana	nanam-pinoana
nanampitsaharana	nanam-pitsaharana
nanampofonaina	nanam-pofonaina
nananarandreniny	nananaran-dreniny
nanandalàna	nanan-dalàna
nanandaza	nanan-daza
nanandoha	nanan-doha
nanandrahalahy	nanan-drahalahy
nanandraharaha	nanan-draharaha
nanandrapeo	nanandra-peo
nanandrariny	nanan-drariny
nanandratanana	nanandra-tanana
nanandratena	nanandra-tena
nanandroa	nanan-droa
nanangantanana	nanangan-tanana
nanangombato	nanangom-bato
nananjanaka	nanan-janaka
nananjanakalahy	nanan-janakalahy
nananjanakavavy	nanan-janakavavy
nananjarandefona	nanan-jaran-defona
nananjavamahory	nanan-java-mahory
nanankaja	nanan-kaja
nanankaloa	nanan-kaloa
nanankamonjy	nanan-kamonjy
nanankarena	nanan-karena
nanankavaly	nanan-kavaly
nanankeloka	nanan-keloka
nanankery	nanan-kery
nanankitafy	nanan-kitafy
nanankohanina	nanan-kohanina
nanantandroka	nanan-tandroka
nanantanimboaloboka	nanan-tanim-boaloboka
nanantarehy	nanan-tarehy
nanantombo	nanan-tombo
nanantombompahendrena	nanan-tombom-pahendrena
nanantontena	nananton-tena
nanantsaina	nanan-tsaina
nanantsakaiza	nanan-tsakaiza
nanantsiny	nanan-tsiny
nanaovambatisa	nanaovam-batisa
nanaovandraharaha	nanaovan-draharaha
nanaovandrainy	nanaovan-drainy
nanaovandreniny	nanaovan-dreniny
nanaramorona	nanara-morona
nanarampo	nanaram-po
nanaranampo	nanaranam-po
nanaronkenatra	nanaron-kenatra
nanatanjatena	nanatanja-tena
nanatontena	nanaton-tena
nandahateny	nandaha-teny
nandatsabato	nandatsa-bato
nandatsadrà	nandatsa-drà
nandrasantsika	nandrasan-tsika
nandrendribahoaka	nandrendri-bahoaka
nandriandrainy	nandrian-drainy
nanentsintadiny	nanentsin-tadiny
nangaladia	nangala-dia
nangalandralehilahy	nangalan-dralehilahy
nangalarindRahely	nangalarin-dRahely
nangatahindralehilahy	nangatahin-dralehilahy
naninjitanana	naninji-tanana
nanjakandRehoboama	nanjakan-dRehoboama
nankahàdoza	nankahà-doza
nanolatanana	nanola-tanana
nanolokanina	nanolo-kanina
nanolotanana	nanolo-tanana
Nanolotanana	Nanolo-tanana
nanolotena	nanolo-tena
nanolotsaina	nanolo-tsaina
nanongilantsofina	nanongilan-tsofina
nanononandralehilahy	nanononan-dralehilahy
nanopakopadamba	nanopakopa-damba
nanorinday	nanorin-day
nanosodiloilo	nanoso-diloilo
nanosomenaka	nanoso-menaka
nanosorampaty	nanosoram-paty
napetradravehivavy	napetra-dravehivavy
nasatrodreniny	nasatro-dreniny
nasiandratsy	nasian-dratsy
Natanameleka	Natana-meleka
nataondRabsake	nataon-dRabsake
nataondrainao	nataon-drainao
nataondrainy	nataon-drainy
nataondralehilahy	nataon-dralehilahy
nataondravehivavy	nataon-dravehivavy
nataondRehoboama	nataon-dRehoboama
nataontànan	nataon-tànan
nataontanana	nataon-tanana
nataony	natao-ny
natorondralehilahy	natoron-dralehilahy
navalindravehivavy	navalin-dravehivavy
nendahantanana	nendahan-tanana
nentinanaisotra	nenti-nanaisotra
nentinanao	nenti-nanao
nentindravehivavy	nentin-dravehivavy
nentindrazana	nentin-drazana
Nergalasarezera	Nergala-sarezera
niadiankevitra	niadian-kevitra
niainandReo	niainan-dReo
niakarandRezina	niakaran-dRezina
niarabelona	niara-belona
niaradia	niara-dia
niaramaty	niara-maty
niaramonina	niara-monina
niaranafatotra	niara-nafatotra
niaranahazo	niara-nahazo
niaranalevina	niara-nalevina
niaranamindro	niara-namindro
Niaranampahorina	Niara-nampahorina
niarananambara	niara-nanambara
niarananandratra	niara-nanandratra
niarananao	niara-nanao
niarananarampo	niara-nanaram-po
niarananatsoboka	niara-nanatsoboka
niaranandao	niara-nandao
niaranandeha	niara-nandeha
Niaranandositra	Niara-nandositra
niaranandroso	niara-nandroso
niarananiry	niara-naniry
niarananjaka	niara-nanjaka
niarananompo	niara-nanompo
niaranapetrany	niara-napetrany
niaranatao	niara-natao
niaranataony	niara-nataony
niaranatsangana	niara-natsangana
niaranatsangany	niara-natsangany
niaraniakatra	niara-niakatra
niaraniandry	niara-niandry
niaraniangona	niara-niangona
niaraniaritra	niara-niaritra
niaraniasa	niara-niasa
niaranidina	niara-nidina
niaraniditra	niara-niditra
niaranifaly	niara-nifaly
niaranifatotra	niara-nifatotra
niaranihatsaravelatsihy	niara-nihatsaravelatsihy
niaranihazakazaka	niara-nihazakazaka
niaranihevitra	niara-nihevitra
niaranihinana	niara-nihinana
niaranihinankanina	niara-nihinan-kanina
niaranihira	niara-nihira
niaranikarapoka	niara-nikarapoka
niaranilentika	niara-nilentika
niaranilevina	niara-nilevina
niaraniloka	niara-niloka
niaraniondrana	niara-niondrana
niaranipetraka	niara-nipetraka
niaranirohitra	niara-nirohitra
niaranisaina	niara-nisaina
niaraniseho	niara-niseho
niaranisotro	niara-nisotro
niaranita	niara-nita
niaranitoetra	niara-nitoetra
niaranitondra	niara-nitondra
niaranitsangana	niara-nitsangana
niaranivavaka	niara-nivavaka
niaranivoaka	niara-nivoaka
niaranoforana	niara-noforana
niaranomendrainy	niara-nomen-drainy
niaranonina	niara-nonina
niararan	niara-ran
niaratorotoro	niara-torotoro
niaritory	niari-tory
niasadia	niasa-dia
nidirandoza	nidiran-doza
Nidirandoza	Nidiran-doza
nifampihazondoha	nifampihazon-doha
nifanarakevitra	nifanara-kevitra
nifandefontehezana	nifandefon-tehezana
nifanolobodirindrina	nifanolo-bodirindrina
nifimbiby	nifim-biby
nifindiona	nifin-diona
niharandoza	niharan-doza
nihetsijaza	nihetsi-jaza
nihifikifidoha	nihifikifi-doha
nihinankanina	nihinan-kanina
nihoabava	nihoa-bava
nihosindavenona	nihosin-davenona
nihosindrà	nihosin-drà
nihosintany	nihosin-tany
nilaozandreniny	nilaozan-dreniny
niloabava	niloa-bava
niloapeo	niloa-peo
ninonoanjaza	ninonoan-jaza
niombondraharaha	niombon-draharaha
nirindrimbaravarana	nirindrim-baravarana
nisambobola	nisambo-bola
nisaratsaina	nisara-tsaina
nisarondoha	nisaron-doha
nisarontava	nisaron-tava
nisiampiainana	nisiam-piainana
nisokabava	nisoka-bava
nitampimbava	nitampim-bava
nitandefona	nitan-defona
nitaraimpahoriana	nitaraim-pahoriana
nitarehimbarahina	nitarehim-barahina
nitarehimboromahery	nitarehim-boromahery
nitarehindiona	nitarehin-diona
Nitarehinjanak	Nitarehin-janak
nitarehinjavamamirapiratra	nitarehin-java-mamirapiratra
nitarehinkerobima	nitarehin-kerobima
nitarehintànan	nitarehin-tànan
nitarehintanana	nitarehin-tanana
nitarehintanàna	nitarehin-tanàna
nitaridalana	nitari-dalana
nitataovovonana	nitatao-vovonana
nitatibolana	nitati-bolana
nitehatanana	niteha-tanana
nitehatratra	niteha-tratra
nitehinko	nitehin-ko
niterabavy	nitera-bavy
niteradahy	nitera-dahy
niteradrivotra	nitera-drivotra
niterahandreninao	niterahan-dreninao
nitetitena	niteti-tena
nitodidoha	nitodi-doha
nitoejaza	nitoe-jaza
nitorabato	nitora-bato
nitoradefona	nitora-defona
nitoriteny	nitori-teny
nitsahajaza	nitsaha-jaza
nitsahaniteny	nitsaha-niteny
nitsahanono	nitsaha-nono
nitsanganko	nitsangan-ko
nitsodrano	nitso-drano
nivadipo	nivadi-po
nivalandrà	nivalan-drà
nivarobary	nivaro-bary
nivarotena	nivaro-tena
nivoatsetroka	nivoa-tsetroka
nizahantoetra	nizahan-toetra
Noamona	No-amona
nobetaindralehilahy	nobetain-dralehilahy
nodimandry	nodi-mandry
nofomboriky	nofom-boriky
nofonjazakely	nofon-jazakely
nofontsandriny	nofon-tsandriny
nohamasinindrainy	nohamasinin-drainy
noharoharoanjavamanitra	noharoharoan-java-manitra
noharoharoanjavatra	noharoharoan-javatra
nokasihinkareza	nokasihin-kareza
nokasihintanana	nokasihin-tanana
nolanjaindroa	nolanjain-droa
nolavindRehoboama	nolavin-dRehoboama
nolazaindralehilahy	nolazain-dralehilahy
Nomendalàna	Nomen-dalàna
nomendrainy	nomen-drainy
nomendralehilahy	nomen-dralehilahy
nomendreniny	nomen-dreniny
nopehimby	nopehim-by
nosindranomasina	nosin-dranomasina
notapahindoha	notapahin-doha
notompoindrainy	notompoin-drainy
notorahambato	notoraham-bato
novidimbola	novidim-bola
noviraviraimbiby	noviraviraim-biby
noviravirainbiby	noviravirain-biby
novonointsabatra	novonoin-tsabatra
nozoimpahoriana	nozoim-pahoriana
nyfirenena	ny-firenena
nytaona	ny-taona
Obededoma	Obed-edoma
odimaso	odi-maso
ohateny	oha-teny
olambolamena	olam-bolamena
olantanana	olan-tanana
olomahantra	olo-mahantra
olomahantranao	olo-mahantranao
olomahatoky	olo-mahatoky
olomahay	olo-mahay
olomaheriny	olo-maheriny
olomahery	olo-mahery
olomahitsy	olo-mahitsy
olomalahelo	olo-malahelo
olomalalako	olo-malalako
olomalaza	olo-malaza
Olomalaza	Olo-malaza
olomalazany	olo-malazany
olomaloto	olo-maloto
olomanantsaina	olo-manan-tsaina
olomarina	olo-marina
Olomarina	Olo-marina
olomasiaka	olo-masiaka
olomasin	olo-masin
olomasìna	olo-masìna
olomasiny	olo-masiny
olombaovao	olom-baovao
olombaventy	olom-baventy
olombetaveta	olom-betaveta
olombitsy	olom-bitsy
olomboafidin	olom-boafidin
olomboafidiny	olom-boafidiny
olomboafidy	olom-boafidy
olomboaozona	olom-boaozona
olomboavidy	olom-boavidy
olombonjena	olom-bonjena
olomeloka	olo-meloka
olomiaina	olo-miaina
olomirahalahy	olo-mirahalahy
olompantany	olom-pantany
olompantatrareo	olom-pantatrareo
olompantatro	olom-pantatro
olompeheziny	olom-peheziny
olompetsy	olom-petsy
olompidiny	olom-pidiny
olompoana	olom-poana
Olompoana	Olom-poana
olompotsy	olom-potsy
olonapeheziny	olona-peheziny
olondiso	olon-diso
olondoza	olon-doza
olondozabe	olon-dozabe
olondratsy	olon-dratsy
olondrehetra	olon-drehetra
olonkafa	olon-kafa
olonkandalo	olon-kandalo
olonkandova	olon-kandova
olonkendrin	olon-kendrin
olonkendrinao	olon-kendrinao
olonkendriny	olon-kendriny
olonkendry	olon-kendry
olonko	olon-ko
olonkojerena	olon-kojerena
olontiako	olon-tiako
olontiana	olon-tiana
ombelahintongony	ombelahin-tongony
ombelahintongotr	ombelahin-tongotr
ombelahintongotrao	ombelahin-tongotrao
ombelahintongotry	ombelahin-tongotry
ombilaindrainao	ombilain-drainao
omemboninahitra	omem-boninahitra
Omemboninahitra	Omem-boninahitra
omentangy	omen-tangy
ondrindrainy	ondrin-drainy
onjandrano	onjan-drano
onjandranomasina	onjan-dranomasina
orampanala	oram-panala
orampanalan	oram-panalan
orinjavatsoa	orin-java-tsoa
orinkazo	orin-kazo
oronkisoa	oron-kisoa
osidia	osi-dia
osindrainy	osin-drainy
otripo	otri-po
Ozenasera	Ozena-sera
ozoimpahoriana	ozoim-pahoriana
Pahatamoaba	Pahata-moaba
paosintrano	paosin-trano
pehimby	pehim-by
Perezoza	Perez-oza
petadrindrintsika	peta-drindrintsika
Pibeseta	Pi-beseta
Pihahirota	Pi-hahirota
Pokeretahazebaima	Pokereta-hazebaima
Potifera	Poti-fera
Rabamagy	Raba-magy
Rabasarisa	Raba-sarisa
rafibato	rafi-bato
rafilahindRezina	rafilahin-dRezina
rafozambavin	rafozam-bavin
rafozambavy	rafozam-bavy
rafozanaovavy	rafozanao-vavy
rafozanivavy	rafozani-vavy
rahalahindrain	rahalahin-drain
rahalahindrainao	rahalahin-drainao
rahalahindrainy	rahalahin-drainy
raharahampanjakana	raharaham-panjakana
raharahampanjakana	raharaha-mpanjakana
raharahampisoronana	raharaham-pisoronana
rahateo	raha-teo
rahavavindreninao	rahavavin-dreninao
rahavavindreniny	rahavavin-dreniny
rahompotsy	rahom-potsy
raikidela	raiki-dela
raikipitia	raiki-pitia
raikitahotra	raiki-tahotra
Raikitahotra	Raiki-tahotra
raindrazavazavy	rain-drazavazavy
raindrazazalahy	rain-drazazalahy
raindrazazavavy	rain-drazazavavy
raindreninao	rain-dreninao
rairaindrihan	rairain-drihan
rakimalalany	raki-malalany
Ramataimazofima	Ramataima-zofima
Ramatalehy	Ramata-lehy
ramboaloboka	ram-boaloboka
Ramotagileada	Ramota-gileada
randrambolamena	randram-bolamena
ranjanak	ran-janak
rankisoa	ran-kisoa
ranomasimpahoriana	ranomasim-pahoriana
Ranomasintsira	Ranomasin-tsira
ranomboaloboka	ranom-boaloboka
ranomboalobokao	ranom-boalobokao
ranomboaloboko	ranom-boaloboko
ranomboalobony	ranom-boalobony
ranompahoriana	ranom-pahoriana
ranompanala	ranom-panala
ranompangidiana	ranom-pangidiana
ranondavenona	ranon-davenona
ranonorambaratra	ranonoram-baratra
ranonorampitahiana	ranonoram-pitahiana
Ranonorampitahiana	Ranonoram-pitahiana
ranonorandanitra	ranonoran-danitra
ranotrambo	rano-trambo
rantsankazo	rantsan-kazo
rantsankazo	ran-tsan-kazo
Rantsankazo	Rantsan-kazo
rantsankazony	rantsan-kazony
rantsantanako	rantsan-tanako
rantsantànan	rantsan-tànan
Rantsantànan	Rantsan-tànan
rantsantanana	rantsan-tanana
rantsantananao	rantsan-tananao
rantsantananareo	rantsan-tananareo
rantsantanany	rantsan-tanany
rantsantànany	rantsan-tànany
rantsantongony	rantsan-tongony
rantsantongotra	rantsan-tongotra
rarahandavenona	rarahan-davenona
rarivatompasan	rarivatom-pasan
rarivatompasany	rarivatom-pasany
ravinkazo	ravin-kazo
ravintsofin	ravin-tsofin
ravintsofina	ravin-tsofina
ravintsofiny	ravin-tsofiny
Regemameleka	Regema-meleka
Rehobotira	Rehobot-ira
rendrainy	ren-drainy
reninjaza	renin-jaza
renitantely	reni-tantely
resilahatry	resi-lahatry
resinkenatra	resin-kenatra
Rimonapareza	Rimona-pareza
rindrintrano	rindrin-trano
Ririatasana	Ririata-sana
Rislotatabara	Rislota-tabara
rivodoza	rivo-doza
rivokavandra	rivo-kavandra
rivomahamay	rivo-mahamay
rivomahery	rivo-mahery
roanjato	roan-jato
roapolo	roa-polo
Roapolo	Roa-polo
roatokombolana	roatokom-bolana
Romamtiezera	Romamti-ezera
ronkena	ron-kena
rononomandry	ronono-mandry
rononompanahy	rononom-panahy
rononondreniny	rononon-dreniny
sabatantaona	sabatan-taona
saborantsinainy	saboran-tsinainy
safodrano	safo-drano
Safodrano	Safo-drano
safodrorohany	safo-drorohany
Sahandrà	Sahan-drà
sahantrano	sahan-trano
saimpetsy	saim-petsy
saindalin	sain-dalin
saindalina	sain-dalina
saindiso	sain-diso
saindratsy	sain-dratsy
sainkafa	sain-kafa
sakaizandrainao	sakaizan-drainao
sakantrano	sakan-trano
sakeliboaloboka	sakeli-boaloboka
sakeliboalobony	sakeli-boalobony
sakelidalana	sakeli-dalana
sakelidrano	sakeli-drano
sakelidranomasina	sakeli-dranomasina
sakelidranon	sakeli-dranon
salohimbary	salohim-bary
salohimvary	salohim-vary
sambobelona	sambo-belona
sambofiara	sambo-fiara
sampahomboaloboka	sampahom-boaloboka
sampamboaloboka	sampam-boaloboka
sampamboalobony	sampam-boalobony
sampanandalana	sampanan-dalana
sampandrano	sampan-drano
sampandranony	sampan-dranony
sampandrofia	sampan-drofia
sampandrotra	sampan-drotra
sampankazo	sampan-kazo
sampindrainy	sampin-drainy
sandrintànany	sandrin-tànany
saridrofia	sari-drofia
sarimbehivavy	sarim-behivavy
sarimbiby	sarim-biby
sarimboantango	sarim-boantango
sarimbolantsinana	sarim-bolan-tsinana
sarimborona	sarim-borona
sarindehilahy	sarin-dehilahy
sarindiona	sarin-diona
sarinjavany	sarin-javany
sarinjavatr	sarin-javatr
sarinjavatra	sarin-javatra
sarinkazandrano	sarin-kazandrano
sarintanàna	sarin-tanàna
sarobidy	saro-bidy
sarodalana	saro-dalana
sarompony	sarom-pony
sarontratra	saron-tratra
saropantarina	saro-pantarina
saropiaro	saro-piaro
Saropiaro	Saro-piaro
saropo	saro-po
sarotadiavina	saro-tadiavina
sarotahotra	saro-tahotra
sasapoana	sasa-poana
satroboninahiny	satro-boninahiny
satroboninahitr	satro-boninahitr
satroboninahitra	satro-boninahitra
satroboninahitrao	satro-boninahitrao
satroboninahitrareo	satro-boninahitrareo
satroboninahitro	satro-boninahitro
satroboninahitry	satro-boninahitry
Savekiriataima	Save-kiriataima
Searajasoba	Seara-jasoba
sehatrasariety	sehatra-sariety
Selahamalekota	Sela-hamalekota
Setarabozenay	Setara-bozenay
sezamboninahitra	sezam-boninahitra
sezampanjakany	sezam-panjakany
Sihoralibnata	Sihora-libnata
silabato	sila-bato
Simronamerona	Simrona-merona
singambolo	singam-bolo
singambolony	singam-bolony
siosionteny	siosion-teny
sisimbolo	sisim-bolo
sisimbolondohanareo	sisim-bolon-dohanareo
sisimboly	sisim-boly
sisindamban	sisin-damban
sisindambanao	sisin-dambanao
sisindambany	sisin-dambany
sisindrano	sisin-drano
sisintanin	sisin-tanin
sisintaniny	sisin-taniny
sisintany	sisin-tany
sitradralehilahy	sitra-dralehilahy
sitrapo	sitra-po
sivifolo	sivi-folo
sivinjato	sivin-jato
soavalinkalesy	soavalin-kalesy
Sokotabenota	Sokota-benota
solabato	sola-bato
solofonkazo	solofon-kazo
solombarahina	solom-barahina
solombato	solom-bato
solombavako	solom-bavako
solomby	solom-by
solompanjaka	solom-panjaka
solompanjaka	solo-mpanjaka
solondrainao	solon-drainao
solondrihitra	solon-drihitra
solonkazo	solon-kazo
sombimofo	sombi-mofo
sombimofonao	sombi-mofonao
sombimpasika	sombim-pasika
sombinjavatra	sombin-javatra
sombinkaniko	sombin-kaniko
sombinkanina	sombin-kanina
sombinkazo	sombin-kazo
sombintsofina	sombin-tsofina
sombintsombinjavatra	sombintsombin-javatra
somotraviavindambany	somotraviavin-dambany
sondriandresaka	sondrian-dresaka
sondriantory	sondrian-tory
soradamba	sora-damba
soratànan	sora-tànan
sorokena	soro-kena
Syrofoinika	Syro-foinika
tadimpoitrao	tadim-poitrao
tafaradalana	tafara-dalana
tafiodrivotra	tafio-drivotra
tafiodrivotrao	tafio-drivotrao
tafontranoko	tafon-tranoko
tahahafantatra	ta-hahafantatra
tahahafaty	ta-hahafaty
tahahalala	ta-hahalala
tahahatsiaro	ta-hahatsiaro
Tahahatsiaro	Ta-hahatsiaro
tahahazo	ta-hahazo
tahahita	ta-hahita
tahaka	ta-haka
tahamadika	ta-hamadika
tahamaly	ta-hamaly
tahamiravira	ta-hamiravira
tahamongotra	ta-hamongotra
tahamonjy	ta-hamonjy
tahamono	ta-hamono
tahamototra	ta-hamototra
tahampahatahotra	ta-hampahatahotra
tahampahatsiaro	ta-hampahatsiaro
tahampitahotra	ta-hampitahotra
tahanadina	ta-hanadina
tahanala	ta-hanala
tahanamarina	ta-hanamarina
tahanambady	ta-hanam-bady
tahanangona	ta-hanangona
tahanankarena	ta-hanan-karena
tahanao	ta-hanao
tahanaraka	ta-hanaraka
tahanasitrana	ta-hanasitrana
tahanavotra	ta-hanavotra
tahandahateny	ta-handaha-teny
tahandahatra	ta-handahatra
tahandeha	ta-handeha
tahandova	ta-handova
tahandratra	ta-handratra
tahandray	ta-handray
tahandre	ta-handre
tahandringana	ta-handringana
tahandroso	ta-handroso
tahaneho	ta-haneho
tahanidy	ta-hanidy
tahanimba	ta-hanimba
tahanontany	ta-hanontany
tahasiana	ta-hasiana
tahomboalobok	tahom-boalobok
tahomboaloboka	tahom-boaloboka
tahomboalobony	tahom-boalobony
tahondrongony	tahon-drongony
taimbolafotsy	taim-bolafotsy
taimboromailala	taim-boromailala
taindrendrika	tain-drendrika
taindrendrikao	tain-drendrikao
taindroroha	tain-droroha
taindrorohany	tain-drorohany
takelabarahina	takela-barahina
takelaboaloboka	takela-boaloboka
takelabola	takela-bola
takelabolafotsy	takela-bolafotsy
takelabolamena	takela-bolamena
takondrivotra	takon-drivotra
takopery	tako-pery
talohandrainy	talohan-drainy
tamàntoerana	tamàn-toerana
tambitamby	tambitam-by
tamimbehivavy	tamim-behivavy
tamimpahendrena	tamim-pahendrena
tamimpaty	tamim-paty
tamimpifaliana	tamim-pifaliana
taminboninahitra	tamin-boninahitra
tamindamba	tamin-damba
tamindRabsake	tamin-dRabsake
tamindRahaba	tamin-dRahaba
tamindRahely	tamin-dRahely
tamindrainao	tamin-drainao
tamindrainy	tamin-drainy
tamindralehilahy	tamin-dralehilahy
tamindravehivavy	tamin-dravehivavy
tamindrazazavavy	tamin-drazazavavy
tamindRebeka	tamin-dRebeka
tamindRehoboama	tamin-dRehoboama
tamindreniny	tamin-dreniny
tamindRota	tamin-dRota
taminkery	tamin-kery
tamintahotra	tamin-tahotra
tamintsakaiza	tamin-tsakaiza
tamitrano	tami-trano
tamorondalana	tamoron-dalana
tampanahy	tam-panahy
tampo	tam-po
tampondoha	tampon-doha
tampondohan	tampon-dohan
tampondohanao	tampon-dohanao
tampondohany	tampon-dohany
tampontrano	tampon-trano
tampontranony	tampon-tranony
tampony	tam-pony
tànamaherin	tàna-maherin
tànamahery	tàna-mahery
tànamasoandro	tàna-masoandro
tànandrazazavavy	tànan-drazazavavy
tànandroan	tànan-droan
tanankodia	tanan-kodia
Tanatasilo	Tanata-silo
tandalàna	tan-dalàna
tandropamonjena	tandro-pamonjena
tanihay	tani-hay
tanimbary	tanim-bary
tanimboalobok	tanim-boalobok
tanimboaloboka	tanim-boaloboka
tanimboalobokao	tanim-boalobokao
tanimboalobokareo	tanim-boalobokareo
tanimboalobokay	tanim-boalobokay
tanimboaloboko	tanim-boaloboko
tanimboaloboky	tanim-boaloboky
tanimboalobony	tanim-boalobony
tanimbolimboantango	tanimbolim-boantango
tanimboninkazo	tanim-boninkazo
tanindrazako	tanin-drazako
tanindrazanao	tanin-drazanao
tanindrazany	tanin-drazany
tanintsika	tanin-tsika
tanintsira	tanin-tsira
tantarampirazanana	tantaram-pirazanana
tantarandRehoboama	tantaran-dRehoboama
tanytahaka	tany-tahaka
taolamaina	taola-maina
taolampanaviko	taolam-panaviko
taolandamosina	taolan-damosina
taolantehezana	taolan-tehezana
taolantehezany	taolan-tehezany
taompahavokarana	taom-pahavokarana
taompamafazana	taom-pamafazana
taompamoazan	taom-pamoazan
taompanafahana	taom-panafahana
taompijinjana	taom-pijinjana
taompiotazamboaloboka	taom-piotazam-boaloboka
taompiotazana	taom-piotazana
taompivelezanareo	taom-pivelezanareo
taondasa	taon-dasa
taonitsy	taon-itsy
Taonjato	Taon-jato
taonjina	taon-jina
taozavatra	tao-zavatra
taozavatrao	tao-zavatrao
tapabalahana	tapa-balahana
tapabolana	tapa-bolana
tapadamba	tapa-damba
tapadoha	tapa-doha
tapakazo	tapa-kazo
tapakazon	tapa-kazon
tapakazony	tapa-kazony
tapaporohana	tapa-porohana
tapatanana	tapa-tanana
tapatongotra	tapa-tongotra
tapijavatra	tapi-javatra
tapinisotro	tapi-nisotro
taranadraiko	tarana-draiko
taranadrainao	tarana-drainao
taranadrainy	tarana-drainy
tarehindiona	tarehin-diona
tarehintsoratra	tarehin-tsoratra
taridalan	tari-dalan
taridositra	tari-dositra
taroboaloboka	taro-boaloboka
tataombaravaran	tataom-baravaran
tataombaravarana	tataom-baravarana
Tatimahodsy	Tatima-hodsy
tavandralehilahy	tavan-dralehilahy
tavimbilany	tavim-bilany
Tavimbilany	Tavim-bilany
tavindrano	tavin-drano
Tavindranoko	Tavin-dranoko
tazandrainy	tazan-drainy
tehiady	te-hiady
tehiala	te-hiala
tehiaraka	te-hiaraka
tehiaro	te-hiaro
tehidinidinika	te-hidinidinika
tehidinika	te-hidinika
tehiditra	te-hiditra
tehieritreritra	te-hieritreritra
tehifandahatra	te-hifandahatra
tehihaino	te-hihaino
Tehihaino	Te-hihaino
tehihazona	te-hihazona
tehihinana	te-hihinana
tehimbolamena	tehim-bolamena
tehimby	tehim-by
tehimpahamarinana	tehim-pahamarinana
tehimpahitsiana	tehim-pahitsiana
tehimpanjakako	tehim-panjakako
Tehimpanjakako	Tehim-panjakako
tehimpanjakan	tehim-panjakan
tehimpanjakana	tehim-panjakana
tehimpanjakanao	tehim-panjakanao
tehirakotra	te-hirakotra
tehirehareha	te-hirehareha
Tehirenireny	Te-hirenireny
tehiseho	te-hiseho
tehitandrina	te-hitandrina
tehitelina	te-hitelina
tehitoetra	te-hitoetra
tehitondra	te-hitondra
tehitsangana	te-hitsangana
tehitsara	te-hitsara
tehitsinjo	te-hitsinjo
teho	te-ho
Teho	Te-ho
tehoharabain	te-hoharabain
Telaharsa	Tela-harsa
Telamela	Tela-mela
telimoka	teli-moka
telonjato	telon-jato
telopolo	telo-polo
Telopolo	Telo-polo
tendrombohitra	tendrom-bohitra
tendrontsoratra	tendron-tsoratra
tenimpahalalana	tenim-pahalalana
tenindRabsake	tenin-dRabsake
tenindrainy	tenin-drainy
tenindravehivavy	tenin-dravehivavy
tenindRebeka	tenin-dRebeka
tenindry	tenin-dry
tenivavolombelon	teni-vavolombelon
tenivavolombelona	teni-vavolombelona
tenivavolombelonao	teni-vavolombelonao
tenivavolombelony	teni-vavolombelony
tenomboaroy	tenom-boaroy
terabavy	tera-bavy
terabehivavy	tera-behivavy
teradahy	tera-dahy
Teradahy	Tera-dahy
teradrainy	tera-drainy
teradreniny	tera-dreniny
teramena	tera-mena
teramenan	tera-menan
tetidratsy	teti-dratsy
tiandralehilahy	tian-dralehilahy
Tiglatopilesera	Tiglato-pilesera
Timnataheresa	Timnata-heresa
Timnatasera	Timnata-sera
Tobadonia	Tob-adonia
Tobalakaina	Tobala-kaina
toepanahin	toe-panahin
toepanahinareo	toe-panahinareo
toepanahy	toe-panahy
toetenako	toe-tenako
toetsainareo	toe-tsainareo
tohotanteliko	toho-tanteliko
tohotantely	toho-tantely
Tohotantely	Toho-tantely
tokamaso	toka-maso
tokambolo	tokam-bolo
tokandreniny	tokan-dreniny
tokantrano	tokan-trano
tokazo	to-kazo
tokombidiny	tokom-bidiny
tokonambaravarako	tokonam-baravarako
tokonambaravaran	tokonam-baravaran
tokonambaravarana	tokonam-baravarana
tokonambavahady	tokonam-bavahady
tokonjandriko	tokon-jandriko
tolambaravarako	tolam-baravarako
tolambaravaran	tolam-baravaran
tolambaravarana	tolam-baravarana
tolambavahady	tolam-bavahady
tombamborakareo	tombam-borakareo
tombohinkase	tombohin-kase
tombokase	tombo-kase
tombokasen	tombo-kasen
tombokaseny	tombo-kaseny
tombokavatsa	tombo-kavatsa
tombombarony	tombom-barony
tombombarotr	tombom-barotr
tombombarotra	tombom-barotra
tombondahinao	tombon-dahinao
Tompomarika	Tompo-marika
tompombady	tompom-bady
tompondavaka	tompon-davaka
tompondova	tompon-dova
tomponjavatra	tompon-javatra
tompontany	tompon-tany
tompontrano	tompon-trano
tompontrosa	tompon-trosa
tompontsambo	tompon-tsambo
tompotrano	tompo-trano
tompotrosa	tompo-trosa
tondradrano	tondra-drano
tondradronono	tondra-dronono
tondromolotra	tondro-molotra
tongobato	tongo-bato
tongobatony	tongo-batony
tongobiby	tongo-biby
tongodralehilahy	tongo-dralehilahy
tongodravehivavy	tongo-dravehivavy
tononkalon	tonon-kalon
tononkira	tonon-kira
tononkirampanahy	tonon-kiram-panahy
tontalinkeviny	tontalin-keviny
tontalinkevitry	tontalin-kevitry
torakovitra	tora-kovitra
torankovitra	toran-kovitra
Torankovitra	Toran-kovitra
toriteny	tori-teny
toroankevitra	toroan-kevitra
tovontany	tovon-tany
tramaraina	tra-maraina
tranoavo	trano-avo
tranobeny	trano-beny
tranobongon	trano-bongon
tranolaiko	trano-laiko
tranolain	trano-lain
tranolaintsika	trano-laintsika
tranolainy	trano-lainy
tranolay	trano-lay
Tranolay	Trano-lay
tranomaizina	trano-maizina
tranombahiny	tranom-bahiny
tranombehivavy	tranom-behivavy
tranomborona	tranom-borona
tranompanjakana	tranom-panjakana
tranondrainao	tranon-drainao
tranondrainy	tranon-drainy
tranondralehilahy	tranon-dralehilahy
tranondreninareo	tranon-dreninareo
tranonjanatsipìka	tranon-jana-tsipìka
tranonjanatsipìkanao	tranon-jana-tsipìkanao
tranonjanatsipìkany	tranon-jana-tsipìkany
tranonkala	tranon-kala
tranonkalany	tranon-kalany
trapahoriana	tra-pahoriana
tratsipìka	tra-tsipìka
tsangambato	tsangam-bato
tsangambaton	tsangam-baton
Tsangambaton	Tsangam-baton
tsangambatontsampinao	tsangam-baton-tsampinao
tsangambatontsampiny	tsangam-baton-tsampiny
tsangambatontsampy	tsangambaton-tsampy
tsangambatontsampy	tsangam-baton-tsampy
tsangambatotsampy	tsangam-bato-tsampy
tsangankazo	tsangan-kazo
tsangankazonareo	tsangan-kazonareo
Tsarafitodiantsambo	Tsara-fitodian-tsambo
tsiAndriamanitra	tsi-Andriamanitra
tsifahafahamponao	tsi-fahafaham-ponao
tsifahafantaranareo	tsi-fahafantaranareo
tsifahafatesana	tsi-fahafatesana
tsifahalalan	tsi-fahalalan
tsifahalalana	tsi-fahalalana
tsifahalalanareo	tsi-fahalalanareo
tsifahalalany	tsi-fahalalany
tsifahalòvana	tsi-fahalòvana
tsifahamarinan	tsi-fahamarinan
tsifahamarinana	tsi-fahamarinana
tsifahamarinantsika	tsi-fahamarinantsika
tsifahamarinany	tsi-fahamarinany
tsifahampiankanina	tsi-fahampian-kanina
tsifaharatsiana	tsi-faharatsiana
tsifaharetanareo	tsi-faharetanareo
tsifahavanonan	tsi-fahavanonan
tsifahazakanao	tsi-fahazakanao
tsifahazoany	tsi-fahazoany
tsifahitantory	tsi-fahitan-tory
tsifahitany	tsi-fahitany
tsifahononana	tsi-fahononana
tsifamorana	tsi-famorana
tsifampitovian	tsi-fampitovian
tsifampodian	tsi-fampodian
tsifananako	tsi-fananako
tsifananan	tsi-fananan
tsifananana	tsi-fananana
tsifananandamba	tsi-fananan-damba
tsifananany	tsi-fananany
tsifanarahan	tsi-fanarahan
tsifanarahana	tsi-fanarahana
tsifanarahandalàna	tsi-fanarahan-dalàna
tsifanasoavany	tsi-fanasoavany
tsifaneken	tsi-faneken
tsifanekena	tsi-fanekena
tsifankatoavandalàna	tsi-fankatoavan-dalàna
tsifetezan	tsi-fetezan
tsififoran	tsi-fiforan
tsifihatsarambelatsihy	tsi-fihatsaram-belatsihy
tsifimonomononana	tsi-fimonomononana
tsifinoako	tsi-finoako
tsifinoan	tsi-finoan
tsifinoana	tsi-finoana
tsifinoanay	tsi-finoanay
tsifinoany	tsi-finoany
tsifiovan	tsi-fiovan
tsifisalasalana	tsi-fisalasalana
tsifisian	tsi-fisian
tsifisiana	tsi-fisiana
tsifisianjavatra	tsi-fisian-javatra
tsifisiankanina	tsi-fisian-kanina
tsifisiantany	tsi-fisian-tany
tsifisiantsiny	tsi-fisian-tsiny
tsifitandreman	tsi-fitandreman
tsifitenenana	tsi-fitenenana
tsifitovian	tsi-fitovian
tsifivadihana	tsi-fivadihana
tsimadainao	tsima-dainao
tsimaday	tsima-day
tsinambolana	tsinam-bolana
tsindriampanahy	tsindriam-panahy
tsindrianjavatra	tsindrian-javatra
tsironjavatra	tsiron-javatra
tsodrano	tso-drano
Tsodrano	Tso-drano
tsodranoko	tso-dranoko
tsodranon	tso-dranon
tsodranonao	tso-dranonao
tsodrivotra	tso-drivotra
vadindrahalahinao	vadin-drahalahinao
vadindrahalahiny	vadin-drahalahiny
vadindrainy	vadin-drainy
vadindralehilahy	vadin-dralehilahy
vadindravehivavy	vadin-dravehivavy
vaditsindranondrainao	vaditsindranon-drainao
vaditsindranondrainy	vaditsindranon-drainy
vaditsindranondralehilahy	vaditsindranon-dralehilahy
vakimbola	vakim-bola
valanoranomboriky	valanoranom-boriky
valimpahasasarana	valim-pahasasarana
valimpitia	valim-pitia
valimpitian	valim-pitian
valimpitianao	valim-pitianao
valimpitianareo	valim-pitianareo
valimpitiany	valim-pitiany
valindrà	valin-drà
valindrihana	valin-drihana
valinteny	valin-teny
valonjato	valon-jato
valopolo	valo-polo
Valopolo	Valo-polo
vanonko	vanon-ko
vaovaoizay	vaovao-izay
varavarampanantenana	varavaram-panantenana
varavarampasana	varavaram-pasana
varavarampinoana	varavaram-pinoana
varavarankely	varavaran-kely
varomaty	varo-maty
vatankazo	vatan-kazo
vatontsatroboninahitra	vaton-tsatro-boninahitra
vavafonao	vava-fonao
vavahadimbahoaka	vavahadim-bahoaka
vavahadindoharano	vavahadin-doharano
vavahadindrano	vavahadin-drano
vavahadindrenirano	vavahadin-drenirano
vavahadinjezika	vavahadin-jezika
vavahadinkazandrano	vavahadin-kazandrano
vavahadintanàna	vavahadin-tanàna
vavahadintranomaizina	vavahadin-trano-maizina
vavahadintsoavaly	vavahadin-tsoavaly
vavalavaka	vava-lavaka
vavaranomasina	vava-ranomasina
vavatany	vava-tany
vavavarahina	vava-varahina
vavintsavily	vavin-tsavily
vazantany	vazan-tany
velarimpoana	velarim-poana
velomaso	velo-maso
velondahy	velon-dahy
velonjaza	velon-jaza
velonjazalahy	velon-jazalahy
velonko	velon-ko
ventinkanina	ventin-kanina
vidimbola	vidim-bola
vidindrà	vidin-drà
vidintany	vidin-tany
vinantonaolahy	vinantonao-lahy
vinantonivavy	vinantoni-vavy
vivery	vi-very
Voafatopahoriana	Voafato-pahoriana
voaforantanana	voaforan-tanana
voahosindrà	voahosin-drà
voahosodiloilo	voahoso-diloilo
voalobodratsy	voalobo-dratsy
voalohambokatr	voaloham-bokatr
voalohambokatra	voaloham-bokatra
voalohambokatrao	voaloham-bokatrao
voalohambokatrareo	voaloham-bokatrareo
voalohambokatry	voaloham-bokatry
voalohambolana	voaloham-bolana
voalohambolanareo	voaloham-bolanareo
voalohambolany	voaloham-bolany
voalohampahendrena	voaloham-pahendrena
voalohampamantarana	voaloham-pamantarana
voalohandahy	voalohan-dahy
voalohanterak	voalohan-terak
voalohanteraka	voalohan-teraka
voalohanteraky	voalohan-teraky
voambary	voam-bary
voandrafy	voan-drafy
voanjavatra	voan-javatra
Voanjavatra	Voan-javatra
voanjavatrao	voan-javatrao
voanjavatrareo	voan-javatrareo
voankazo	voan-kazo
voantsimparifary	voan-tsimparifary
voantsimperifery	voan-tsimperifery
voantsinapy	voan-tsinapy
voasarondrano	voasaron-drano
voasaronkenatra	voasaron-kenatra
voatorabato	voatora-bato
voatrabaka	voa-trabaka
voatrabaky	voa-trabaky
voaviravirambiby	voaviraviram-biby
Voaviravirambiby	Voaviraviram-biby
vodiandriny	vodi-andriny
vodifanjaitra	vodi-fanjaitra
vodilalan	vodi-lalan
vodilalana	vodi-lalana
vodilalanao	vodi-lalanao
vodilalanareo	vodi-lalanareo
vodilalany	vodi-lalany
vodirindrina	vodi-rindrina
vodisambo	vodi-sambo
voditenon	vodi-tenon
vodivoampelatanana	vodivoam-pelatanana
vodivoniny	vodi-voniny
vokatsoa	voka-tsoa
volampanjakana	volam-panjakana
volioliva	voli-oliva
volombava	volom-bava
volombavany	volom-bavany
volombehivavy	volom-behivavy
volombiby	volom-biby
volondohako	volon-dohako
volondohanao	volon-dohanao
volondohanareo	volon-dohanareo
volondohandravehivavy	volondohan-dravehivavy
volondohany	volon-dohany
volondrameva	volon-drameva
volontongotra	volon-tongotra
vongampanala	vongam-panala
vongampiraka	vongam-piraka
vongantsira	vongan-tsira
voninjavatra	vonin-javatra
vonoanolona	vonoan-olona
vontompahoriana	vontom-pahoriana
vontondiloilo	vonton-diloilo
vontondrà	vonton-drà
vontondrano	vonton-drano
Vontondrano	Vonton-drano
vontontsoka	vonton-tsoka
vorodamba	voro-damba
voromailala	voro-mailala
voromanidina	voro-manidina
voronkely	voron-kely
vosodratsy	voso-dratsy
vovotaniny	vovo-taniny
vovotany	vovo-tany
vozondobaka	vozon-dobaka
Zafenatapanea	Zafenata-panea
zafindohaliny	zafin-dohaliny
zafinilahy	zafini-lahy
zafinivavy	zafini-vavy
zanabadiny	zana-badiny
zanabahiny	zana-bahiny
zanabahoaka	zana-bahoaka
Zanabaratra	Zana-baratra
zanaboaloboka	zana-boaloboka
zanabohiny	zana-bohiny
zanabohitr	zana-bohitr
zanabohitra	zana-bohitra
zanabohitrao	zana-bohitrao
zanabola	zana-bola
zanaboriky	zana-boriky
zanaboromahery	zana-boromahery
zanaboromailala	zana-boromailala
zanadiloilo	zana-diloilo
zanadiona	zana-diona
Zanadiona	Zana-diona
zanadrahalahin	zana-drahalahin
zanadrahalahiny	zana-drahalahiny
zanadRahely	zana-dRahely
zanadravehivavy	zana-dravehivavy
zanadRebeka	zana-dRebeka
zanadreniny	zana-dreniny
zanagoaika	zana-goaika
Zanajovy	Zana-jovy
zanakailahy	zanakai-lahy
zanakaivavy	zanakai-vavy
zanakalahindRahely	zanakalahin-dRahely
zanakalahindRehoboama	zanakalahin-dRehoboama
zanakalahindreninao	zanakalahin-dreninao
zanakalahindRobena	zanakalahin-dRobena
Zanakalahy	Zanaka-lahy
ZanakAndriamanitra	Zanak-Andriamanitra
zanakaolahy	zanakao-lahy
zanakaovavy	zanakao-vavy
zanakareolahy	zanakareo-lahy
zanakareovavy	zanakareo-vavy
zanakavanao	zana-kavanao
zanakavavin	zanaka-vavin
zanakavavindrainy	zanakavavin-drainy
zanakavavindreninao	zanakavavin-dreninao
zanakavavindreniny	zanakavavin-dreniny
zanakazo	zana-kazo
zanakazony	zana-kazony
zanakolahy	zanako-lahy
zanakovavy	zanako-vavy
Zananilahy	Zanani-lahy
zanapanjakana	zana-panjakana
zanatsipìka	zana-tsipìka
Zanatsipìka	Zana-tsipìka
zanatsipikako	zana-tsipikako
zanatsipikako	zana-tsi-pikako
zanatsipìkan	zana-tsipìkan
Zanatsipìkan	Zana-tsipìkan
zanatsipìkanao	zana-tsipìkanao
zanatsipìkany	zana-tsipìkany
zanatsipiky	zana-tsipiky
zarafanapahana	zara-fanapahana
zarafanapahany	zara-fanapahany
zaralova	zara-lova
zaralovany	zara-lovany
zarandefona	zaran-defona
zarandefony	zaran-defony
zaratanin	zara-tanin
zarataninao	zara-taninao
zarataninareo	zara-taninareo
zarataninay	zara-taninay
zaratanindrainy	zara-tanin-drainy
zarataniny	zara-taniny
zaratany	zara-tany
Zaretasahara	Zareta-sahara
zavabaovao	zava-baovao
zavabetaveta	zava-betaveta
ZAVABETAVETA	ZAVA-BETAVETA
zavaboatendry	zava-boatendry
zavadehibe	zava-dehibe
Zavadehibe	Zava-dehibe
zavadratsinao	zava-dratsinao
zavadratsiny	zava-dratsiny
zavadratsy	zava-dratsy
zavamadinika	zava-madinika
zavamahafaty	zava-mahafaty
zavamahafinaritra	zava-mahafinaritra
zavamahagaga	zava-mahagaga
Zavamahagaga	Zava-mahagaga
zavamahaloto	zava-mahaloto
zavamahamamo	zava-mahamamo
zavamahameloka	zava-mahameloka
zavamaharikivy	zava-maharikivy
zavamaharikoriko	zava-maharikoriko
zavamahasoa	zava-mahasoa
zavamahatahotra	zava-mahatahotra
Zavamahatahotra	Zava-mahatahotra
zavamahatsiravina	zava-mahatsiravina
zavamahitsy	zava-mahitsy
zavamaitso	zava-maitso
zavamalaza	zava-malaza
Zavamalaza	Zava-malaza
zavamaloto	zava-maloto
zavamamy	zava-mamy
zavamanan	zava-manan
zavamanana	zava-manana
zavamananaaina	zava-manana-aina
zavamandady	zava-mandady
zavamaneno	zava-maneno
zavamanenon	zava-manenon
zavamangidy	zava-mangidy
Zavamangidy	Zava-mangidy
zavamaniry	zava-maniry
zavamanitra	zava-manitra
zavamanitrao	zava-manitrao
zavamanitro	zava-manitro
zavamasin	zava-masin
zavamasìna	zava-masìna
zavamasinao	zava-masinao
zavamasinareo	zava-masinareo
zavamasiny	zava-masiny
zavamatavy	zava-matavy
zavamendrika	zava-mendrika
zavamiafina	zava-miafina
Zavamiafina	Zava-miafina
ZAVAMIAFINA	ZAVA-MIAFINA
zavamiaina	zava-miaina
zavamihetsiketsika	zava-mihetsiketsika
zavaniafina	zava-niafina
zavapadina	zava-padina
zavapanahy	zava-panahy
zavapiko	zava-piko
zavapiny	zava-piny
zavapoana	zava-poana
Zavapoana	Zava-poana
zavapoanany	zava-poanany
zavapy	zava-py
zavatsarobidy	zava-tsaro-bidy
zavatsarotra	zava-tsarotra
zavatsoa	zava-tsoa
zavatsoako	zava-tsoako
zavatsoan	zava-tsoan
zavatsoanao	zava-tsoanao
zavatsoany	zava-tsoany
zazabodo	zaza-bodo
zazavakimanta	zaza-vakimanta
zokinaovavy	zokinao-vavy
zokiolona	zoki-olona
zorondalana	zoron-dalana
zorontrano	zoron-trano
zorontranon	zoron-tranon
zotompanahy	zotom-panahy
zotompo	zotom-po
zotompoko	zotom-poko
zotompon	zotom-pon
zotomponareo	zotom-ponareo
	
